trifle	vi. 嘲笑； 轻视 n. 琐事，小事，无价值的东西
adapt	vt. 使适应； 改编
cable	n. 缆，索，电缆，电报 vt. 给… 发电报， 用电报传送
epoch	n. （新）时代；历元
resume	n. （谋职者的）个人简历
burden	n. 重担，精神负担 vt. 加重压于， 烦扰； 负担， 装载
stroke	n. 中风；一举，一次努力；划桨，划水；击，敲；报时的钟声；笔画，一笔；抚摸 vt. 抚摸
plaster	n. 灰浆，灰泥；石膏；橡皮膏，膏药 vt. 在…上抹灰泥， 厚厚地涂抹
commitment	n. 承诺， 许诺， 保证； 信奉， 献身； 承担的义务
unfold	v. 展开， 打开； 显露， 展现
motivate	vt. 作为…的动机； 激励， 激发
severe	adj. 严重的； 严厉的， 严格的； 严峻的， 艰难的； 朴素的， 不加装饰的
plausible	adj. 似有道理的， 似乎正确的， 貌似可信的
keen	adj. 热心的； 激烈的； 敏锐的， 敏捷的
valid	adj. 有效的， 正当的； 有根据的， 有理的
corporate	adj. 法人团体的， 公司的； 全体的， 共同的
mild	adj. 温柔的； 温暖的； 轻微的
surge	vi. 蜂拥而出；洋溢，奔放；汹涌，奔腾 n. 洋溢， 奔放； 急剧上升， 猛增； 浪涛般汹涌奔腾
conference	n. 会议， 讨论会； 讨论， 商谈
offspring	n. 子女， 子孙， 后代； 崽
genetic	adj. 遗传的 n. [-s]遗传学
peck	v. 啄，啄起
innovation	n. 新方法， 新事物； 革新， 创新
incentive	n. 刺激， 鼓励
erect	adj. 竖直的， 挺直的 vt. 建造，使竖立
Moslem	n. 穆斯林 adj. 穆斯林的
tentative	adj. 试探的， 试验的
faculty	n. 才能， 能力； 系， 科； 全体教员
inspire	vt. 鼓舞； 给…以灵感
criticism	n. 批评， 批判； 评论， 评论文章
plunder	v. 掠夺，劫掠 n. 掠夺，抢劫
ambition	n. 雄心， 抱负， 野心； 期望得到的东西
explore	v. 探险， 探索； 仔细查阅， 探究
appease	vt. 平息， 抚慰； 姑息
recognition	n. 认出， 识别； 承认， 确认， 认可； 赏识， 表彰， 报偿
infinite	adj. 无限的， 无数的
differentiate	vi. 区分，区别 vt. 区分， 区别； 使不同， 使有差异
dissipate	vi. 消散，消失 vt. 使消散， 使消失； 浪费， 挥霍
fluctuate	vi. 波动， 涨落， 起伏
prose	n. 散文
criticize	vt. 批评， 评论， 非难
probe	v. 探索，查究，调查；用探针探查，探测 n. 探针， 探测器； 探索， 调查
salute	vi. 敬礼，致意 vt. 向…敬礼，向…致意；赞扬，颂扬 n. 敬礼， 致意
orient	vi. 转向特定方向；适应[theO-] vt. 使适应，使熟悉情况；使朝向，以…为方向 n. 东方， 亚洲， 东半球
prescription	n. 处方， 药方， 药； 开处方， 开药方
juvenile	adj. 少年的，少年特有的；幼稚的，不成熟的 n. 未成年人， 少年
hop	vi. 单足跳跃，单足跳行；齐足跳跃，齐足跳行 vt. 跳上 n. 蹦跳； 短程航行
stereotype	n. 陈规，老套，固定的模式 vt. 对…形成固定看法
lounge	n. （旅馆等的）休息室
scheme	v. 密谋， 策划 n. 计划，方案；阴谋
suicide	n. 自杀 v. 自杀
divine	adj. 神的， 神授的， 天赐的； 极好的， 极美的
preserve	vt. 保护， 维持； 保存， 保藏； 腌制
acquaintance	n. 认识， 了解； 熟人
humble	adj. 谦逊的；地位低下的；简陋的 vt. 使谦恭； 使卑下
tug	v. 用力拖 n. 拖船； 猛拉， 牵引
vain	adj. 徒劳的； 自负的
appearance	n. 出现， 来到； 外观
primarily	adv. 首先， 主要地
device	n. 器械， 装置； 设计； 手段， 策略
electric	adj. 电的， 电动的
label	n. 标签，标记，符号 vt. 贴标签于； 把…称为
pilgrim	n. 朝圣者
occur	vi. 发生， 出现， 存在； 被想起， 被想到
shrug	n&v. 耸肩
insurance	n. 保险； 保险费
rotate	v. （使）旋转
chorus	v. 合唱，齐声说
breed	n. （动物）品种
scrape	v. 刮，擦；勉强过日子 n. 刮， 擦； 刮擦声
repay	v. 偿还；报答
terrify	vt. 使害怕， 使惊吓
graduate	adj. 研究生的 v. 毕业 n. 毕业生；研究生
degenerate	vi. 衰退，堕落，蜕化 adj. 衰退的，堕落的 n. 堕落者
coalition	n. 结合体， 同盟； 结合， 联合
handbook	n. 手册， 便览
focus	v. 聚焦；集中 n. 焦点， 中心
refreshment	n. （精力的）恢复，爽快
fury	n. 狂怒， 暴怒； 狂暴， 狂烈
harden	v. 变硬
ticket	n. （交通违章）罚款传票
toll	v. 敲 n. 过路费，过桥费；伤亡人数，损失
moral	adj. 道德的，有道德的 n. 品行， 道德规范； 寓意
reaction	n. 反应， 反作用
accommodate	vt. 容纳； 向…提供住处； 使适应， 顺应
liner	n. 衬里； 大客轮
vast	adj. 巨大的， 大量的； 浩瀚的
property	n. 财产， 所有物； 房产； 物业； 性质， 性能
optimistic	adj. 乐观的， 乐观主义的
dignity	n. 庄严， 端庄； 尊严， 高贵
gross	adj. 总的； 严重的； 粗俗的； 臃肿的
plunge	n&v. 纵身投入， 猛冲， 猛跌
exile	n. 流放，流亡；被流放者，流亡国外者 vt. 流放， 放逐， 使流亡
garment	n. 衣服
reliance	n. 依靠， 依赖
treaty	n. 条约， 协议， 协定
pudding	n. 布丁
embarrass	vt. 使窘迫， 使为难
precede	vt. 在…之前， 先于
hypothesis	n. 假设， 假说， 前提
spoil	vi. 变质 vt. 损坏，糟蹋；宠坏，溺爱 n. 战利品， 掠夺物
diplomat	n. 外交官， 外交家； 有交际手腕的人， 圆滑的人
undergo	vt. 经历； 经受， 忍受
infant	adj. 婴儿的， 幼稚的 n. 婴儿
duplicate	adj. 完全一样的， 复制的 n. 完全一样的东西，复制品 vt. 复制， 复印； 重复
dual	adj. 双的， 两重的
forge	vt. 打制， 锻造； 伪造
velocity	n. 速度， 速率
recipient	n. 接受者， 接收者
lounge	vi. 倚，躺；闲逛，闲荡 n. 休息厅， 休息室
array	n. 展示；陈列，一系列；排列，队形；衣服，盛装；
spectacle	n. 演出， 场面； 景象， 壮观； 眼镜
dimension	n. 尺寸， 尺度， 面积； 方面， 特点； 面积， 规模
reject	vt. 拒绝； 拒纳， 退回， 摈弃 n. 被拒货品， 不合格产品
impact	v. 影响， 作用， 冲击 n. [Im'pækt]
seam	n. 缝， 接缝； 煤层
anonymous	adj. 无名的， 不具名的； 匿名的； 无特色的， 无个性特征的
aggravate	vt. 加重， 加剧， 使恶化； 激怒， 使恼火
imaginary	adj. 想象中的， 假想的
permeate	v. 弥漫， 遍布， 散布； 渗入， 渗透
relative	adj. 有关系的，相对的 n. 亲属， 亲戚
blink	vi. 眨眼睛；闪亮，闪烁 n. 眨眼睛； 一瞬间
immerse	vt. 使浸没； 使沉浸在， 使专心于
chronic	adj. 慢性的， 久病的； 长久的， 不断的； 积习难改的
intent	adj. 专心的， 专注的； 急切的 n. 意图，意向，目的
edible	adj. 可以吃的， 可食用的
permissible	adj. 可允许的， 许可的
association	n. 协会， 团体； 联合， 交往
lane	n. 小路， 跑道； 航道， 航线
heel	n. 脚后跟， 踵； 后跟
persuasion	n. 说服， 劝说； 信念， 信仰
communication	n. 通讯， 交流， 交际； 通信工具， 交通联系
disease	n. 病， 疾病； 不健全， 弊端
clip	n. 夹子，回形针，别针；弹夹，弹仓；剪，修剪；剪报，电影片断 vt. 夹住， 扣住； 剪， 修剪
indifferent	adj. 冷漠的， 不积极的； 一般的， 平平的
eliminate	vt. 消灭， 消除， 排除； 淘汰
deviate	v. （使）背离，偏离
luxury	n. 奢侈； 奢侈品
isolate	vt. 使隔离， 使孤立
legal	adj. 法律的； 合法的
preferable	adj. 更可取的， 更好的， 更合意的
allocate	vt. 分配； 分派， 把…拨给
complex	adj. 由许多部分组成的，复合的；复杂的，难懂的 n. 综合体， 集合体； 情结， 夸大的情绪反应
chant	vt. 反复有节奏地喊叫；吟诵，咏唱 n. 反复有节奏的喊叫； 赞美诗， 圣歌
paternity	n. 父权， 父子关系
commend	vt. 称赞， 表扬； 推荐
skip	vi. 跳，蹦跳；跳绳 vt. 跳过，略过，漏过 n. 跳， 蹦跳
enhance	vt. 提高， 增加， 加强
elite	n. [总称] 上层人士， 掌权人物， 实力集团； [总称]出类拔萃的人， 精英
bribe	vt. 向…贿赂，买通 n. 贿赂， 行贿物
shrimp	n. （小）虾，河虾，褐虾
flap	vi. 飘动， 拍动； 振翅 n. 片状垂悬物；飘动，摆动，振动；激动，慌忙状态 vt. 使拍动，使飘动
expand	v. 扩大， 膨胀
desire	vt. 想要，渴望 n. 愿望， 欲望
stumble	vi. 绊脚， 绊倒； 跌跌撞撞地走； 结结巴巴
grain	n. 谷物， 谷粒， 颗粒； 少量， 微量
notion	n. 概念， 观念； 意图， 想法， 念头
negotiate	v. 洽谈， 协商， 谈判； 顺利通过， 成功越过
dine	vi. 进餐 vt. 宴请
capsule	n. 胶囊； 航天舱， 密封舱
cluster	vi. 群集，丛生 n. 串，簇；群，组 vt. 使群集， 集中
convey	vt. 表达； 传递； 运送， 输送
tendency	n. 趋向， 趋势， 倾向
demand	vt. 要求，需要；询问 n. 要求， 需要
pope	n. （罗马天主教的）教皇
federal	adj. 联邦的， 联盟的
ignite	vi. 着火 vt. 点燃，引发
extravagant	adj. 奢侈的； 过度的， 过分的， 放肆的
homogeneous	adj. 同种类的， 同性质的， 有相同特征的
eternal	adj. 永久的， 永世的； 无休止的； 永恒的， 永不改变的
militant	adj. 激进的；好斗的 n. 激进分子， 斗士
bronze	n. 青铜， 青铜色， 古铜色； 青铜制品， 铜牌
preclude	vt. 排除； 阻止， 妨碍
signify	vi. 有重要性 vt. 表示…的意思，意味，预示
conclude	vi. 结束， 终了 vt. 推断出，推论出；缔结，议定
accessory	n. 附件， 零件， 配件； 装饰品； 同谋， 帮凶， 包庇犯
corpse	n. 死尸， 尸体
brew	vi. 冲泡；酝酿，行将发生 vt. 酿造；冲泡 n. 冲泡的饮料
scorn	n. 轻蔑，鄙视 vt. 轻蔑， 鄙视； 拒绝， 不屑
bacteria	n. 细菌
dread	vt. 担忧，忧虑；惧怕 n. 担忧， 畏惧
territory	n. 领土， 版图； 领域
submit	vi. 屈从， 听从； 忍受； 甘心 vt. 屈从，听从，服从；呈送，提交；主张，建议
fling	v. （用力）扔，抛
scrub	v. 用力擦洗，把…擦净；取消 n. 矮树丛， 灌木丛
denial	n. 否认； 拒绝， 拒绝给予
instantaneous	adj. 瞬间的， 即刻的
cabin	n. 小屋； 船舱， 机舱
approval	n. 赞成， 同意； 认可， 批准
score	n. 得分，比数，成绩；二十 vt. 分， 给…打分； 画线于； 获胜
emerge	vi. 出现， 涌现， 冒出
vital	adj. 生死攸关的， 极其重要的； 生命的， 有生命力的
educational	adj. 教育的， 教育性的
beneficial	adj. 有利的， 有益的
deprive	vt. 剥夺， 使丧失
strain	v. 扭伤， 拉伤； 尽力使用， 紧张； 拉紧； 尽力 n. 拉紧；过劳，极度紧张；张力；扭伤，拉伤；旋律；品种，家系；气质，个性特点
cordial	adj. 热情友好的， 热诚的
applaud	vi. 鼓掌，喝彩 vt. 向…鼓掌， 向…喝彩； 称赞， 赞许
eligible	adj. 有条件被选中的； 合适的， 合意的
exhaust	vt. 使筋疲力尽，用尽；详尽论述 n. 排气装置； 废气
exclude	vt. 把…排除在外
streak	vi. 飞跑，疾驶 n. 条纹，条痕；个性特征；一阵子，一连串 vt. 在…上加条纹
stride	vi. 大踏步走 n. 大步； 步法， 步态； 进展， 进步
enclosure	n. 四周有篱笆的场地， 围场； 附件
client	n. 委托人， 当事人； 顾客
levy	vt. 征收 n. 征税， 税款
insulation	n. 绝缘
pathetic	adj. 差劲的， 令人生厌的； 引起怜悯的， 可怜的， 可悲的
decade	n. 十年， 十年期
function	vi. 工作， 运行； 起作用 n. 功能，职务；【数】函数；重大聚会
void	adj. 无效的；没有的，缺乏的 n. 空虚感，寂寞感；真空，空白 vt. 使无效
recover	v. 重新获得， 挽回； 恢复
fluorescent	adj. 荧光的， 发荧光的
restrict	vt. 限制， 约束， 限定
settle	v. 安排， 安放； 调停； 支付， 核算； 安家； 飞落， 停留； 安定
conform	vi. 遵守， 适应； 顺从； 相似， 一致， 符合
dutiful	adj. 恭敬顺从的； 尽职的
huddle	vi. 聚集在一起，挤作一团；把身子蜷成一团，蜷缩 vt. 使聚集在一起 n. 挤在一起的人； 一堆杂乱的东西
likelihood	n. 可能， 可能性
illustrate	vt. 说明
glare	vi. 怒目而视；发射强光，发出刺眼的光线 n. 强光； 怒视， 瞪眼； 炫耀， 张扬
contribution	n. 贡献； 促成作用； 捐款， 捐献物； 稿件
visceral	adj. 内脏的， 腑脏的； 出自内心的， 发自肺腑的
shrink	vi. 起皱； 收缩； 退缩， 畏缩
revenue	n. 收入， 收益； 税收， 岁入
cemetery	n. 墓地， 公墓
bonus	n. 奖金， 红利； 额外给予的东西
disclose	vt. 揭露， 泄露， 透露
awkward	adj. 笨拙的， 尴尬的； 难操纵的， 使用不便的； 不灵巧的
clue	n. 线索， 暗示， 提示
available	adj. 现成可使用的， 通用的； 可取的； 联系的； 可得到的
screw	n. 螺丝 vt. 用螺钉固定， 拧， 拧紧
mobilize	vi. 动员起来 vt. 动员；调动，鼓动起
seemingly	adv. 表面上， 看上去
considerable	adj. 相当大的； 重要的
hitherto	adv. 到目前为止， 迄今
continuity	n. 连续， 持续
graphic	adj. 生动的， 形象的； 绘画的， 文字的， 图表的
commute	vi. 乘公交车上下班，经常乘车往返于两地 vt. 减； 折合， 折偿； 上下班交通
proclaim	vt. 宣告， 宣布， 声明； 显示
tariff	n. 关税， 税率； 价目表， 收费表
instructional	adj. 指导的， 教育的
divert	vt. 使转向， 使改道； 转移， 转移…的注意力； 使娱乐， 使消遣
tramp	v. 以沉重的脚步走（过） n. 跋涉
thereafter	adv. 之后， 以后
revive	v. 苏醒；复兴
forum	n. 论坛， 讨论会； 专题讨论节目
acute	adj. 严重的； 急性的； 灵敏的， 敏锐的； 精明的
drag	v. 拖，拉；迫使，硬拉；拖着脚步走 n. 累赘； 一吸， 一抽
melancholy	n. 忧郁的 adj. 忧郁，悲伤
exotic	adj. 外来的， 异国情调的； 奇异的
thigh	n. 大腿
pollutant	n. 污染物质
transit	n. 运输， 载运
foster	adj. 收养的 vt. 收养，养育；培养，促进
parasite	n. 寄生生物； 寄生虫
batch	n. 一批， 一组， 一群； 一批生产量
witness	n. 证据；目击者，证人 vt. 目击； 为…作证， 证明
glitter	vi. 闪闪发光，闪耀 n. 闪光， 灿烂的光辉； 耀眼， 辉煌
soluble	adj. 可溶的； 可解决的
intensify	v. 增强， 加剧
abundance	n. 大量， 丰富， 充足
persistent	adj. 坚持不懈的， 执意的； 持续的
interaction	n. 相互作用
stagger	vi. 摇晃，蹒跚 vt. 使吃惊；使错开，使交错 n. 蹒跚， 踉跄
gesture	v. （讲话时等）做手势
shrewd	adj. 机灵的， 敏锐的， 精明的
regime	n. 政治制度， 政权
reservation	n. 预订； 保留； 犹豫； 居留地
input	n. 输入；投入的资金，输入的数据 vt. 把…输入计算机
defendant	n. 被告
shuttle	vi. 穿梭般来回 n. 短程穿梭运行的飞机；航天飞机；梭子 vt. 短程穿梭运送
dominant	adj. 占优势的， 支配的， 统治的； 居高临下的， 高耸的
leaflet	v. 散发传单 n. 传单，散页印刷品，小册子
domestic	adj. 本国的； 家庭的； 驯养的
effective	adj. 有效的； 有影响的
comprehension	n. 理解， 理解力， 领悟； 理解力测验
industrial	adj. 工业的， 产业的
shabby	adj. 破旧的， 衣衫褴褛的； 卑鄙的； 不公正的
unity	n. 单一， 统一， 团结； 和睦， 协调
voluntary	adj. 自愿的， 志愿的
affirm	vt. 断言， 坚持声称； 证实， 确认
maneuver	vi. 设法变动位置； 用策略， 耍花招 n. 谨慎而熟练的动作；策略，花招；演习 vt. 设法使变动位置；操纵，控制
drawback	n. 缺点， 欠缺； 不利条件
vision	n. 想象力， 梦幻； 视力， 视觉
acknowledge	vt. 承认， 承认…的权威； 告知收到， 确认； 对…表示谢意， 报偿
significant	adj. 相当数量的； 重要的， 意义重大的， 意味深长的
pact	n. 契约， 协定， 条约
delicate	adj. 纤细的； 易碎的； 微妙的； 精美的
inaugurate	vt. 开始， 开展； 为…举行就职典礼； 为…举行开幕式， 为…举行落成仪式
equality	n. 等同； 平等； 相等
invert	vt. 使倒转， 使倒置， 使颠倒
migrate	vi. 迁徙， 移栖； 移居， 迁移
chord	n. 和弦
bounce	v. 弹起，反弹，颠跳 n. 弹， 反弹
convict	vt. 证明…有罪，宣判…有罪['kɒnvɪkt] n. 囚犯
arc	n. 弧形； 弧； 电弧， 弧光
bulletin	n. 简明新闻， 最新消息； 公告， 布告， 公报； 学报， 期刊
outrage	n. 义愤，愤慨；暴行，骇人听闻的事件 vt. 激起…的义愤， 激怒
empirical	adj. 以经验为依据的， 经验主义的， 经验的
external	adj. 外部的， 外面的
metallic	adj. 金属的， 金属制的； 有金属特性的， 像金属的
equip	vt. 装备， 配备； 使有准备
sneak	vi. 偷偷地走，溜 vt. 偷偷地做
perception	n. 感知， 觉察； 认识， 观念， 看法
skull	n. 颅骨， 脑壳
snatch	vi. 一把抓住 vt. 夺，夺走，抢走；一下子拉，一把抓住；抓住机会做，抽空做 n. 片断
instruct	vt. 教， 指示； 通知； 教育
trend	vi. 伸向，倾向 n. 倾向
stall	v. 熄火； 拖延， 推迟 n. 货摊；
contemporary	adj. 现代的， 当代的； 同时代的
minimize	vt. 使减少到最低限度； 极力贬低， 对…作最低估计
premium	adj. 高级的，优质的；售价高的 n. 保险金；额外费用，加付款；奖品，赠品；额外津贴
buck	vi. 猛然弓背跃起 n. 美元，澳元；雄鹿，雄兔
maintain	vt. 维持； 维修， 保养； 主张； 赡养
boycott	v. 联合抵制 n. 抵制行动，受抵制时期
cumulative	adj. 积累的， 渐增的
domain	n. 领域， 范围； 领地， 势力范围
armor	n. 盔甲， 装甲； 保护物
jury	n. 陪审团， 评奖团
blossom	vi. 开花； 发展， 长成 n. 花
elapse	v. （时间）过去，消逝
household	adj. 家庭的， 家喻户晓的 n. 家庭，户；家务
assurance	n. 把握， 信心； 保证， 表示保证的话； 保险
pole	n. 杆； 极， 磁极， 电极
evaluate	vt. 评价， 估…的价
grave	adj. 严重的， 严肃的 n. 坟墓
reassure	vt. 使放心
shed	vt. 脱落，脱去；流出，流下；发出，散发 n. 棚， 小屋， 货棚
diploma	n. 毕业文凭， 毕业证书， 资格证书
bewilder	vt. 使迷惑； 使难住
insane	adj. 极蠢的， 荒唐的； 精神病的， 精神失常的， 疯狂的
religious	adj. 宗教的； 笃信宗教的， 虔诚的
allege	vt. 断言， 宣称， 硬说
notorious	adj. 臭名昭著的， 声名狼藉的
majority	n. 多数， 大多数
modesty	n. 谦虚
trait	n. 特征， 特点， 特性
dub	vt. 给…起绰号， 把…称为； 为配音， 译制
decree	n. 法令，政令；判决，裁决 vt. 判决， 命令
startle	vt. 使惊吓， 使吃惊
foam	vi. 起泡沫， 吐白沫 n. 泡沫；泡沫材料，泡沫状物
thrive	vi. 兴旺， 繁荣， 旺盛
occasional	adj. 偶尔的， 间或发生的
foil	n. 箔，金属薄片；陪衬，衬托 vt. 挫败， 使受挫折
rig	vt. 操纵，垄断；给装配帆及索具；用临时替代材料迅速搭起 n. 船桅的装置， 成套器械
tuition	n. 教学， 讲授， 指导； 学费
hum	vi. 哼曲子；发嗡嗡声 vt. 哼 n. 嗡嗡声， 营营声， 嘈杂声
given	adj. 规定的，特定的；假设的，已知的；有癖好的，有倾向的 prep. 考虑到
endow	vt. 资助， 捐赠； 给予， 赋予， 认为…具有某种特质
bleed	vi. 出血，流血；泌脂 vt. 勒索…的钱
scary	adj. 可怕的， 骇人的； 惊慌的， 害怕的； 胆小的， 易受惊的
locomotive	n. 机车
imply	vt. 暗示， 意指
unify	vt. 使联合， 统一； 使相同， 使一致
intellect	n. 智力， 理解力； 才智非凡的人
survive	vi. 活下来，继续存在；幸免于 vt. 从中挺过来； 从…逃出； 比…活得长
float	v. 浮动， 漂浮， 飘动
addition	n. 加， 加法； 附加物
verdict	n. 裁定； 定论， 判断性意见
scrutiny	n. 详细检查， 仔细观察
radiant	adj. 容光焕发的， 喜形于色的； 光芒四射的， 光辉灿烂的； 辐射的
electronic	adj. 电子的 n. 电子学； 电子设备
mission	n. 使命， 任务； 使团
peg	n. 小钉，栓，挂物钉；桩 vt. 用钉子钉， 用钉固定； 限定； 将…看成， 将…归入
board	v. 付费（在某人家里）膳宿
cafeteria	n. 自助餐馆， 自助食堂
soar	vi. 猛增， 剧增； 高飞， 升腾； 高涨； 高耸， 屹立
artillery	n. 火炮， 大炮； 炮兵
ozone	n. 臭氧
distribution	n. 分发， 分配， 分布
athlete	n. 运动员， 体育家
setback	n. 挫折， 倒退， 失败
contempt	n. 轻视， 蔑视
bubble	vi. 冒泡， 起泡， 沸腾 n. 泡，泡沫，水泡，气泡；幻想的计划
attack	n&vt. 攻击， 进攻； 突然发作
disorder	n. 混乱， 杂乱； 骚乱
heritage	n. 遗产； 继承物； 传统
convention	n. 习俗， 惯例； 公约； 会议
redundant	adj. 多余的， 过剩的
stabilize	v. 稳定， 稳固
productivity	n. 生产力； 生产率
tempo	n. 速度； 节奏， 行进速度
patriot	n. 爱国者， 爱国主义者
appropriation	n. 据为己有， 占有； 挪用； 拨款
alleviate	vt. 减轻； 缓解， 缓和
reflect	v. 反映， 显示； 反射， 映现； 深思， 考虑， 反省
companion	n. 同伴， 共事者； 伴侣
shrub	n. 灌木
coherent	adj. 条理清楚的， 连贯的； 一致的， 协调的
situated	adj. 位于…的， 坐落在…的； 处于…境地的
lubricate	vt. 使润滑
spectrum	n. 谱， 光谱， 频谱； 范围， 幅度， 系列
disgust	n&vt. 厌恶， 憎恶
brand	n. 商标，牌子 vt. 铭刻， 打烙印于； 加污名于， 谴责
mute	adj. 缄默的，无声的；哑的，不会说话的；不发音的 vt. 消除， 减轻
hug	vi. 紧抱在一起，互相拥抱 vt. 拥抱；紧抱，怀抱 n. 紧抱， 热烈拥抱
economical	adj. 节约的； 经济学的
gross	adj. （语言、举止）粗俗的
web	n. 网； 网络； 错综复杂的事物
radioactive	adj. 放射性的， 有辐射能的
ingredient	n. 组成部分， 原料； 要素
ivory	n. 象牙； 象牙色， 乳白色
booklet	n. 小册子
endeavor	n&v. 努力， 尽力， 尝试
principal	adj. 最重要的，主要的 n. 负责人， 校长； 资本， 本金； 主要演员， 主角
diagnose	vt. 诊断； 判断
shatter	vi. 碎裂 vt. 使粉碎，砸碎；使破灭；使震惊
scan	vt. 细看，审视，浏览 n. 扫描
symphony	n. 交响乐， 交响曲； 和谐， 协调
productive	adj. 多产的， 富饶的； 富有成效的
repetitive	adj. 重复的， 反复性的
reap	vt. 收割， 收获； 获得， 得到
quart	n. 夸脱
pope	n. 教皇， 罗马主教
chorus	n. 合唱队；合唱，合唱曲；副歌，叠句；齐声，齐声说的话 vt. 齐声说， 随声附和
sulfur	n. 硫
xerox	v. 用静电复印
solidify	v. 凝固
straightforward	adj. 正直的， 坦率的； 易懂的， 简单的
attractive	adj. 有吸引力的， 引起注意的
versus	prep. 以…为对手， 对； 与…相对， 与…相比之下
ear	n. （稻麦等的）穗
tribe	n. 部落； 族
expenditure	n. 经费， 支出额； 花费， 支出， 消耗
aviation	n. 航空， 航空学； 飞机制造业
midst	n. 中部； 中间； 当中
tenant	n. 房客， 佃户
complement	n. 补充，互为补充的东西；编制名额；装备定额；补语['kɒmplɪm3nt] vt. 补充， 与…相配
sensation	n. 感觉能力； 感觉， 知觉； 轰动， 引起轰动的事件
refreshment	n. 茶点， 点心； 恢复， 精神爽快
entertainment	n. 娱乐， 文娱节目， 表演会； 招待， 款待， 请客
swamp	n. 沼泽 vt. 淹没， 浸没； 难倒， 压倒
gaze	n&vi. 凝视， 盯， 注视
elegant	adj. （举止、服饰等）雅致的
irony	n. 反话， 冷嘲， 嘲弄； 具有讽刺意味的事
polar	adj. 地极的， 近地极的； 磁极的； 正好相反的， 截然对立的
symposium	n. 讨论会， 专题报告会； 专题论文集
panel	n. （选定的）专门小组
authorize	vt. 授权， 批准
menace	n. 具有危险性的人；威胁，威吓 vt. 威胁， 威吓
momentum	n. 动力， 冲力， 势头； 动量
transfer	v. 搬， 转移； 调动， 转学； 转让， 过户； 乘车， 转乘
dilute	adj. 稀释的， 冲淡的 vt. 稀释，冲淡
residential	adj. 居住的， 住宅的； 寄宿的， 住在住所的
elementary	adj. 基本的， 初级的
comprehensive	adj. 广泛的； 综合的； 理解的
desirable	adj. 吸引人的， 可取的
military	adj. 军事的；军用的 n. 军队， 武装力量
faith	n. 信任， 信心； 信仰， 信条
mourn	v. 哀悼； 感到痛心
mediate	vi. 调解，斡旋 vt. 经调解解决； 经斡旋促成
diversion	n. 转移， 转向； 消遣， 娱乐； 临时绕行路
hard	adj. （酒）烈性的
flexible	adj. 易弯曲的； 灵活的
constitution	n. 宪法， 章程； 组成； 设立
incorporate	vt. 包含； 加上， 吸收； 把…合并， 使并入
prohibit	vt. 禁止， 不准
resort	vi. 求助，凭借，诉诸 n. 求助， 凭借， 诉诸； 求助的对象， 采用的手段； 常去之地， 胜地
hatred	n. 憎恶， 憎恨， 仇恨
regiment	n. 团；大量 vt. 严格地管制， 严密地编组
paralyze	vt. 使瘫痪， 使麻痹； 使丧失作用； 使惊愕， 使呆若木鸡
behave	vi. 表现，举止；运转，做出反应 vt. 检点自己的行为
exceed	vt. 超过， 胜过， 超出
figure	vi. 出现；合乎情理 n. 数字；人物；算术；体型，风姿；轮廓；画像，塑像；图，图形 vt. 计算； 认为， 猜想
dynamic	adj. 动力的， 动力学的； 动态的； 有活力的， 有生气的
dispose	v. 去掉， 销毁； 处理， 解决； 使倾向于
generate	vt. 发生， 引起； 生殖
summon	vt. 召唤， 传唤； 鼓起， 振作； 召集， 召开
ignore	vt. 不顾， 不理； 忽视
feeble	adj. 虚弱的， 衰弱的， 无力的； 无效的， 无益的
designate	vt. 指派， 委任； 标出； 把…定名为
parallel	adj. 并列的，平行的；类似的；对应的；并联的 n. 可相比拟的事物，相似处；平行线，平行面；纬线 vt. 与…相似， 与… 相当， 比得上
casual	adj. 偶然的； 非正式的； 临时的， 不定期的； 漠不关心的， 冷淡的
slander	n. 诽谤，诋毁 v. 诽谤，诋毁
sergeant	n. 中士， 警官
grant	n. 授给物 vt. 授予， 给予
jingle	v. （使）丁当响
reform	n&v. 改革， 改良， 改造； 改正， 改过自新
minimal	adj. 最小的， 最低限度的
supreme	adj. 最高的， 最大的； 极度的， 最重要的
absorb	vt. 吸收； 吸引…的注意， 使全神贯注； 把…并入， 同化
privilege	n. 特权； 优惠
entitle	vt. 给…权利； 给题名
crush	vt. 压碎， 碾碎， 镇压
resume	vt. 重新开始， 继续， 恢复 n. 摘要， 概要； 简历
feminine	adj. 女性的， 女子的； 女子气的
lever	n. 杠，杠杆；途径，手段，工具 vt. 撬动， 撬起
persist	vi. 坚持， 持续
dedicate	vt. 题献词于上； 把献给， 把用于
quest	n. 寻找， 搜索； 追求
paperback	n. 平装本， 简装本
council	n. 理事会， 委员会
grim	adj. 讨厌的， 糟糕的； 严厉的； 冷酷的， 无情的
bamboo	n. 竹， 竹子
porch	n. 门廊
fraud	n. 欺诈， 诈骗； 骗子
fiction	n. 小说； 虚构， 杜撰
assemble	vi. 集合，召集 vt. 集合， 聚集； 装配
performance	n. 演出； 履行， 执行， 完成； 工作情况， 表现， 工作性能
autonomous	adj. 自治的； 独立自主的
impulse	n. 冲动， 一时的念头； 推动， 驱使； 脉冲
strategy	n. 战略， 策略
tub	n. 桶， 塑料杯， 纸杯； 盆， 洗澡盆， 浴缸
gigantic	adj. 巨大的， 庞大的
poetry	n. 诗， 诗歌， 诗集
drain	vi. 慢慢减少 vt. 排去，放水；渐渐耗尽 n. 耗竭； 排水沟， 排水管
pedestrian	n. 步行者， 行人
masterpiece	n. 杰作
update	vt. 更新；使现代化 n. 最新信息
background	n. 出身背景， 经历； 背景资料； 背景， 底子
sensational	adj. 轰动的， 耸人听闻的； 使人感动的， 非常好的
initiative	n. 主动性， 首创精神； 主动的行动， 倡议； 主动权
gloomy	adj. 忧郁的， 沮丧的； 令人沮丧的； 昏暗的， 阴沉的
quench	vt. 止； 扑灭
lining	n. （衣服里的）衬里
hostile	adj. 敌方的， 不友善的
transport	vt. 运输 n. 运输， 运输工具
buzz	vi. 发出嗡嗡声；忙乱，急行；发出嘈杂的谈话声 n. 嗡嗡声； 嘈杂的谈话声
establish	vt. 建立， 设立； 确立； 证实
pasture	n. 牧草地，牧场 vt. 放牧
scale	n. 大小，规模；等级，级别；天平，磅秤；比例；刻度，标度；鳞 vt. 攀登， 爬越
surgeon	n. 外科医生
boycott	n&vt. 抵制， 拒绝参与
inspiration	n. 灵感； 鼓舞人心的人
collapse	n&vi. 倒坍， 瓦解； 崩溃， 突然失败
highlight	vt. 强调，突出，使显著 n. 最精彩的部分， 最重要的事件
irritate	vt. 使恼怒， 使烦躁； 使不适， 使疼痛
circulation	n. 循环， 流通； 流传， 传播， 发行； 发行量； 流通
elevate	vt. 提升…的职位， 提高， 改善； 使情绪高昂； 举起， 使上升
diminish	vi. 变少，变小，降低 vt. 减少， 减小， 降低
assess	vt. 对估价； 评价， 评论
afford	vt. 担负得起； 提供
bandage	n. 绷带 vt. 用绷带绑扎
expel	vt. 把…除名， 把…开除； 驱逐， 赶走， 放逐； 排出， 喷出
dolphin	n. 海豚
readily	adv. 乐意地， 欣然地； 容易地； 很快地， 立即
condemn	vt. 谴责， 指责； 判…刑， 宣告…有罪
shuttle	n. （织机的）梭
triumph	vi. 成功 n. 凯旋，胜利
concentrate	v. 全神贯注，全力以赴；集中，聚集；浓缩 n. 浓缩物， 浓缩液
pose	v. （使）摆好姿势
imperative	adj. 必要的；紧急的，极重要的；命令的 n. 必要的事， 必须完成的事； 【语】祈使语气
harmony	n. 调和； 协调； 和谐
reckless	adj. 鲁莽的， 不考虑后果的
phase	n. 阶段； 方面； 相， 相位
pastime	n. 消遣， 娱乐
resultant	adj. 作为结果的， 因而发生的
admit	vi. 承认 vt. 承认，供认；准许…进入
perfume	n. 香水，香料，香气 vt. 使充满芳香； 洒香水于
intimidate	vt. 恐吓， 威胁
myth	n. 杜撰出来的人； 神话
periodical	adj. 周期的； 定期的； 时而发生的 n. 期刊
excessive	adj. 过多的， 极度的
participant	n. 参加者， 参与者
quartz	n. 石英
convert	vt. 转变， 转化； 改变
rebellion	n. 反叛， 反抗
gorgeous	adj. 华丽的， 灿烂的， 绚丽的； 令人十分愉快的， 极好的
layoff	n. 解雇； 裁员； 歇工期， 停工期
insect	n. 昆虫， 虫
radical	adj. 根本的，基本的；激进的，激进派的 n. 激进分子
trot	v. （马）小跑 n. （马）小跑；慢跑
grief	n. 悲伤， 悲痛； 悲伤的事， 悲痛的缘由
differentiation	n. 区别
phenomenon	n. 现象， 迹象； 非凡的人
visualize	vt. 想象； 设想
haul	vt. 拖，拉；拖运，运送 n. 拖， 拉， 托运； 一次获得的数量
stimulus	n. 促进； 刺激
sponge	v. 用湿海绵擦， 揩； 过寄生生活 n. 海绵
intrigue	vi. 耍阴谋，施诡计 vt. 激起…的好奇心，迷住 n. 阴谋， 诡计， 密谋
market	v. 推销
efficient	adj. 效率高的； 有能力的
cherish	vt. 珍爱， 珍视； 爱护， 抚育； 抱有， 怀有
imitate	vt. 模仿； 仿效； 仿制
characterize	vt. 成为…的特征， 以…为特征； 描绘的特性， 描述
associate	v. 把…联系在一起；使联合，结合；交往	[ə'səuʃiət] adj. 副的 n. 伙伴，同事
advisable	adj. 可取的； 适当的
presentation	n. 提供， 显示； 外观， 图像； 授予， 赠送； 报告， 介绍； 表演
dock	vi. 靠码头， 进港 n. 码头，船埠；被告席 vt. 使靠码头；扣
subsequent	adj. 随后的， 后来的
prone	adj. 易于…的， 很有可能…的； 俯卧的
recede	vi. 退， 退去， 渐渐远去； 向后倾斜， 缩进
stun	vt. 使震惊， 使目瞪口呆； 把…打昏， 使昏迷
olive	n. 橄榄， 橄榄树
briefcase	n. 公文包， 公事包
exchange	n&vt. 交换； 交流； 兑换
immune	adj. 免疫的， 有免疫力的， 不受影响的； 免除的， 豁免的
liability	n. 责任； 负债， 债务； 不利条件， 起妨碍作用的人
clearance	n. 净空， 余隙； 许可， 批准； 票据交换， 清算； 清除， 清理， 出空
rigorous	adj. 严密的， 缜密的； 严格的， 严厉的
destruction	n. 破坏， 毁灭； 消灭
clown	n. （马戏的）小丑，丑角
reciprocal	adj. 相互的； 互惠的
intervene	vi. 干涉， 干预； 干扰， 阻挠
cord	n. 细绳， 粗线， 索； 灯芯绒裤
upgrade	vt. 提升，使升级 n. 向上的斜坡
hierarchy	n. 等级制度； 统治集团， 领导层
virgin	adj. 未经开发的， 未经使用的， 未经触动的； 处女的 n. 处女，未婚女子
slogan	n. 标语， 口号； 广告语
marsh	n. 沼泽， 湿地
layman	n. 门外汉， 外行
accurate	adj. 准确的， 正确无误的
abrupt	adj. 突然的， 意外的； 唐突的， 鲁莽的
obscure	adj. 不著名的，不重要的；费解的，模糊不清的 vt. 使变糊， 掩盖
compensate	v. 补偿，赔偿
dean	n. 教长， 主任牧师； 学院院长， 系主任， 训导主任
perish	vi. 丧生， 毁灭， 消亡； 失去弹性， 老化
analogy	n. 比拟； 类比， 类推
thermal	adj. 热的， 由热造成的； 保暖的
saturate	vt. 使湿透， 浸透； 使充满， 使饱和
mechanical	adj. 机械的， 机械制造的， 机械学的， 力学的； 呆板的
specialty	n. 特产， 名产， 特色菜； 专业， 专长
substitute	n. 代替人，代用品 vt. 用…代替
inevitable	adj. 不可避免的， 必然的
proceeding	n. 诉讼
bracket	n. 括号；等级段，档次；壁架，托架 vt. 把…置于括号内； 把…归入同一类
boom	vi. 激增， 繁荣， 迅速发展； 发出隆隆声 n. 激增，繁荣，迅速发展；隆隆声，嗡嗡声
enlighten	vt. 启发， 开导
quantify	vt. 确定…的数量， 量化
inhabit	vt. 居住于， 栖居于
abundant	adj. 丰富的， 富裕的； 大量的， 充足的
stray	vi. 走失，迷路；分心，走神；离题 adj. 迷路的，走失的；孤立的，零星的 n. 走失的家畜
crystallize	v. 结晶； 变得清晰而明确； 使具体化
assert	vt. 肯定地说， 断言； 维护， 坚持； 坚持己见
thesis	n. 论文， 毕业论文； 论题， 论点
dubious	adj. 怀疑的， 犹豫不决的， 无把握的； 有问题的； 靠不住的
oxygen	n. 氧， 氧气
tragic	adj. 悲惨的， 可悲的； 悲剧的
medieval	adj. 中世纪的； 中古的
orchestra	n. 管弦乐队
monopoly	n. 垄断， 专卖； 垄断物， 垄断商品， 专卖商品
appeal	vi. 求助，诉请；要求；有吸引力 vt. 控诉，移交上级法院审理 n. 吸引力； 呼吁； 上诉
precious	adj. 珍贵的， 宝贵的
detect	vt. 察觉， 发觉； 侦查出
fort	n. 堡垒， 城堡
zinc	n. 锌
fragile	adj. 易碎的， 脆的， 易损坏的； 虚弱的， 脆弱的
defect	vi. 变节， 叛变 n. 缺点，缺陷，欠缺[dI'fekt]
prevail	vi. 流行， 盛行
comply	vi. 遵从， 依从， 服从
catholic	adj. [C-]天主教的；普遍的，广泛的 n. [C-]天主教徒
intense	adj. 强烈的； 紧张的； 认真的； 热情的
irrespective	adj. 不考虑的， 不顾及的
immigrant	n. 移民， 侨民
necessitate	vt. 成为必要， 需要
monitor	n. 班长；监视器，检测器；显示器 vt. 监听， 检测
repel	vt. 使厌恶； 击退， 逐回， 驱除； 排斥
apply	vi. 应用，实施，使用；适用；申请，请求 vt. 涂， 敷， 施
literal	adj. 照字面的， 原义的； 逐字的
certify	vt. 证明， 证实； 发证书给
tilt	v. （使）倾斜
warehouse	n. 仓库， 货栈
aspiration	n. 强烈的愿望； 志向， 抱负
obesity	n. 过度肥胖
heave	v. 举起，提起；扔；发出；起伏，隆起；呕吐，恶心 n. 举起， 升降
prolong	vt. 延长， 拉长， 拖延
collide	vi. 碰撞， 互撞； 冲突， 抵触
vocal	adj. 喜欢畅所欲言的，直言不讳的；嗓音的，发声的 n. 声乐节目
clan	n. 宗族， 家族
sturdy	adj. 强壮的， 结实的， 坚固的； 坚定的， 坚强的
invaluable	adj. 非常宝贵的， 极为贵重的， 无价的
lunar	adj. 月的， 月球的
equator	n. 赤道
incidence	n. 发生率
competition	n. 比赛； 竞争
symbolic	adj. 符号的； 象征性的
bypass	n. 旁道，迂回道 vt. 绕过， 绕…走； 越过， 置…于不顾
penguin	n. 企鹅
terrain	n. 地形， 地势
numerical	adj. 数字的； 用数字表示的； 数值的
scrap	n. 碎片，碎屑；废金属；残羹剩饭；少量，点滴 vt. 废弃， 抛弃
attempt	vt. 尝试， 试图， 努力
rating	n. 等级， 品级， 评定结果； 收视率， 收听率
nutrition	n. 营养
purity	n. 纯净， 纯洁， 纯正
clamp	vt. 夹紧，夹住，固定 n. 夹头， 夹具， 夹钳
annoy	vt. 使恼怒； 打搅
paragraph	n. 段， 节
watt	n. 瓦
incident	n. 发生的事， 事件
hasty	adj. 草率的， 轻率的； 急速的， 匆忙的， 仓促完成的
counterpart	n. 与对方地位相当的人， 与另一方作用相当的物
slight	adj. 轻微的，微小的 v. 侮慢；轻视，冷落
pirate	n. 非法盗印者，侵犯版权者；海盗 vt. 盗用， 非法盗印
distinct	adj. 与其他不同的； 清楚的， 明确的
overlook	vt. 忽视； 宽恕； 俯瞰
transplant	v. 移植（器官、皮肤等）；移植，移种（植物）
transient	adj. 短暂的， 转瞬即逝的； 临时的， 暂住的
seminar	n. 研究班， 研讨会
gamble	vi. 赌博，打赌；投机，冒险 vt. 赌，以…为赌注 n. 赌博； 投机， 冒险
cater	vi. 满足需要， 迎合； 提供饮食及服务， 承办酒席
solemn	adj. 庄严的， 隆重的； 严肃的
cling	vi. 紧紧抓住； 黏着， 挨近； 依附， 依恋； 坚持， 墨守， 忠实于
breed	v. 繁殖； 养育， 培育； 酿成， 产生 n. 品种
assure	vt. 使确信； 确保， 向…保证
span	n. 跨距，一段时间 vt. 持续， 贯穿， 包括； 横跨， 跨越
assault	n. 攻击， 袭击
simultaneous	adj. 同时发生的， 同时存在的； 同步的， 一齐的
throne	n. 御座， 宝座； 王位， 王权
utmost	adj. 最远的 n. 极限
cavity	n. 洞， 穴， 凹处； 龋洞
furniture	n. 家具
weird	adj. 古怪的， 离奇的； 怪诞的， 神秘而可怕的
corrode	v. 腐蚀， 侵蚀
narrative	n. 叙述文， 故事； 叙述， 讲述
evoke	vt. 唤起， 引起， 使人想起
regulation	n. 规章， 规则； 管理， 控制， 调节
response	n. 回答， 答复； 反应， 响应
outbreak	n. （战争、愤怒等）爆发
chief	adj. 主要的，为首的；总的 n. 首领， 长官； 酋长， 族长
bizarre	adj. 奇形怪状的， 怪诞的
exploit	vt. 剥削； 利用； 开拓 n. 业绩， 功绩
flatter	vt. 向…谄媚， 奉承； 使满意， 使感到荣幸； 使显得好看， 使显得突出
confine	vt. 限制，使局限；使不外出，禁闭
air-conditioning	n. 空调设备， 空调系统
acquaint	vt. 使认识， 使了解； 使熟悉
Thanksgiving	n. 感恩节
headlong	adv. 头向前地 adj. 头向前的
default	v. 不履行义务， 拖欠 n. 违约，拖欠；弃权；预设，缺省
peninsula	n. 半岛
finite	adj. 有限的， 有限制的； 限定的
objective	adj. 客观的， 无偏见的 n. 目标，目的
dramatic	adj. 引人注目的， 激动人心的； 戏剧的
deviate	vi. 背离， 偏离
scrub	v. 擦洗，擦净 n. 擦洗
wretched	adj. 极不愉快的， 难受的， 可怜的； 令人苦恼的， 讨厌的； 拙劣的
snack	n. 快餐， 小吃， 点心
brace	vi. 做好准备；振作精神 vt. 使防备，使受锻炼；支住，撑牢，使绷紧 n. 支架， 托架
optimism	n. 乐观， 乐观主义
versatile	adj. 多才多艺的， 有多种技能的； 有多种用途的， 多功能的， 万用的
slaughter	v. 屠杀；屠宰 n. 屠杀；屠宰
sovereign	adj. 拥有最高统治权的， 至高无上的； 具有独立主权的 n. 君主，元首
linen	n. 日用织品； 亚麻织品， 亚麻布
auction	n&vt. 拍卖
pedlar	n. （挨户兜售的）小贩
bump	vi. 碰，撞；
utility	n. 效用， 有用
charge	v. 索价；控告；使充电，使充满；向前冲 n. 费用； 管理； 控告， 指责； 电荷， 充电
classification	n. 分类， 分级， 分类法； 类别， 级别
sheer	adv. 垂直地，陡峭地 vi. 急转向， 偏离 adj. 完全的，十足的；陡峭的，垂直的；极薄的，透明的
gracious	adj. 亲切的，和蔼的；优美的；雅致的，雍容华贵的 int. 天哪!
disposition	n. 性情， 性格； 意向， 倾向； 排列， 部署
supplementary	adj. 增补的， 补充的
reign	vi. 当政， 统治； 占主导地位 n. 君主的统治，君主的统治时期
origin	n. 起源， 起因； 出身， 血统
preference	n. 喜爱， 偏爱； 优先； 偏爱的事物
growl	v. （狗等）嗥叫；咆哮
plateau	n. 高原； 稳定时期
mock	vi. 嘲笑，嘲弄 adj. 模拟的， 演习的； 假的， 假装的 vt. 嘲笑，嘲弄；模仿
expenditure	n. （时间等）支出，消费
breakthrough	n. 突破， 突破性进展， 重要的新发现
gland	n. 腺
reluctance	n. 不愿， 勉强
destructive	adj. 破坏的， 毁灭的
canvas	n. 帆布； 帆布画布， 油画
perplex	vt. 使困惑， 使费解； 使复杂化
clockwise	adv. 顺时针方向地
deserve	vt. 应受， 值得
literature	n. 文学， 文学作品； 文献， 图书资料
expire	vi. 期满， 终止； 断气， 死亡
transmit	vt. 传送， 传递； 传染； 播送， 发射
stack	n. 堆，垛 vt. 堆积， 堆放于
continual	adj. 连续的； 频频的
purchase	vt. 买，购买 n. 购买； 购买的物品
detective	n. 侦探， 私人侦探
corresponding	adj. 相应的， 符合的
subscribe	vi. 订阅，订购；同意，赞成 vt. 捐助， 赞助
scope	n. 范围； 余地， 机会
essence	n. 本质， 实质， 要素； 精髓， 精华
irrigation	n. 灌溉
magnitude	n. 重要性， 重大； 巨大， 广大
passive	adj. 被动的， 消极的
ambiguous	adj. 引起歧义的， 模棱两可的， 含糊不清的
cork	n. 软木，软木塞 vt. 用瓶塞塞住
spice	n. 香料，调味品；趣味，情趣，风味 vt. 使增添趣味； 加香料于
controversial	adj. 引起争论的， 有争议的
gossip	vi. 传播流言蜚语 n. 流言蜚语；爱说长道短的人
engagement	n. 订婚， 婚约； 约会
impatient	adj. 不耐烦的， 急躁的； 热切的， 急切的
recipe	n. 烹饪法， 食谱； 方法， 秘诀， 诀窍
slope	v. 倾斜 n. 倾斜，斜面
glamor	n. 魅力， 诱惑力
atlas	n. 地图集
refrain	vi. 抑制，克制，戒除 n. 叠句， 副歌
impose	vt. 把…强加； 征
specialist	n. 专家
consultant	n. 顾问； 会诊医师， 专科医生
manifest	adj. 明显的，显然的，明了的 vt. 显示， 表明， 证明； 使显现， 使显露
oriental	adj. 东方的； 东方人的； 东方文化的
profession	n. 职业； 公开表示
groove	n. 沟， 槽
schedule	n. 时刻表，日程安排表；清单，明细表 vt. 安排， 排定
superintendent	n. 主管人， 监管人， 负责人； 警长
conceive	vi. 构想出， 设想； 怀孕 vt. 想出，认为；怀
timely	adj. 及时的， 适时的
affiliate	vt. 使隶属于 n. 附属机构， 分公司
clockwise	adv. 顺时针方向转地 adj. 顺时针方向转的
compartment	n. 卧车包房， 隔间； 分隔的空间
planet	n. 行星
crumble	vi. 崩溃， 瓦解 vt. 弄碎
nominate	vt. 提名， 任命； 推荐， 指定
coincidence	n. 巧合， 巧事； 一致， 符合
discrepancy	n. 不符合， 不一致
generalize	vt. 概括， 归纳， 推断； 普及
quiver	vi. 颤抖，发抖，抖动 n. 颤抖， 抖动， 颤声
smuggle	vt. 走私， 非法私运； 偷运， 偷带
rupture	v. 破裂 n. 破裂，裂开；决裂，断绝
supervise	v. 监督， 管理， 指导
rely	vi. 依靠， 依赖； 信赖， 指望
accustomed	adj. 惯常的， 习惯的
unique	adj. 唯一的， 独一无二的； 极不寻常的， 极好的
turnover	n. 营业额， 成交量； 人员调整， 人员更替率
identical	adj. 完全相同的， 同一的
electricity	n. 电
nuisance	n. 讨厌的人； 麻烦事
frequency	n. 屡次， 次数， 频率； 经常发生
owl	n. 猫头鹰
precise	adj. 精确的， 准确的； 严谨的
hound	n. 猎犬 vt. 追逼， 烦恼， 纠缠
mental	adj. 心理的， 精神的， 思想上的； 精神病的； 智力的
constituent	adj. 组成的， 构成的 n. 选民，选区居民；成分，组成；配料
database	n. 数据库
fertilizer	n. 肥料
constitution	n. （人的）体格，素质
mingle	vi. 混合起来， 相混合； 相交往， 相往来 vt. 使混合，使相混
album	n. 粘贴簿， 集邮簿， 相册
wisdom	n. 智慧
tumble	vi. 跌倒，摔下，滚下；翻滚；暴跌；不由自主地卷入 n. 跌倒， 摔倒
priority	n. 优先， 重点； 优先考虑的事
cardinal	adj. 最重要的； 基本的 n. 红衣主教；【数】基数
census	n. 人口普查， 统计
sniff	v. 以鼻吸气，用力吸入；嗅，闻 n. 吸气； 嗅， 闻
maturity	n. 成熟
revolve	v. （使）旋转
opaque	adj. 不透明的， 不透光的； 难理解的， 晦涩的
restore	vt. 恢复， 使恢复； 修复， 整修； 归还， 交还
knob	n. 球形把手， 球形柄； 旋钮； 小块
urge	v. 强烈希望
ruin	v. 毁坏 n. 毁灭；废墟
avoid	vt. 避免， 躲开； 撤销
sprinkle	v. 撒，洒 n. 少量， 少数
prey	vi. 捕食； 折磨， 使烦恼 n. 被捕食的动物，捕获物；受害者
prospective	adj. 预期的； 未来的； 可能的
abolish	vt. 彻底废除， 废止
disposal	n. 丢掉， 销毁； 处理； 排列， 布置
solution	n. 解决； 解决办法； 溶液
directory	n. 人名地址录； 工商行名录； 号码簿
definitely	adv. 一定地， 明确地
mask	n. 面具，面罩，口罩；伪装 vt. 遮盖， 掩饰
proof	adj. 耐…的， 能防…的 n. 证据，证明；校样，样张
elicit	vt. 诱出， 探出
combat	n. 战争，斗争，格斗 vt. 与…斗争， 与…战斗
slice	n. 薄片，切片，部分 vt. 切， 削， 剁
entrepreneur	n. 企业家
interpret	v. 解释， 说明； 口译
intricacy	n. 错综复杂；
option	n. 选择， 选择权， 选择自由； 选择的事物， 选课
acquire	vt. 取得， 获得； 学到
illuminate	vt. 照明， 照亮； 阐明， 启发
latent	adj. 潜在的， 隐伏的， 不易察觉的
sociology	n. 社会学
adjacent	adj. 邻近的， 毗连的
resident	adj. 居住的， 定居的； 住校的， 住院的 n. 居民，定居者；住院医生
restrain	vt. 阻止， 控制； 抑制， 遏制
approach	vt. 向…靠近 n. 靠近； 途径， 方式
trial	n. 试， 试验； 审判； 讨厌的人
barren	adj. 贫瘠的， 荒芜的； 不结果实的， 不育的； 无益的， 没有结果的
relay	n. 接力赛；中继转播 vt. 传送， 传达， 转述； 中继转播
warrant	n. 授权令；理由，根据 vt. 证明…是正当的
profitable	adj. 有利可图的， 有益的
primary	adj. 首要的， 主要的； 基本的； 最初的， 初级的
ambitious	adj. 有抱负的， 雄心勃勃的； 有野心的
respond	vi. 回答， 答复； 作出反应， 响应
retort	n&v. 反驳， 回嘴
consensus	n. 一致， 一致同意
concise	adj. 简明的， 简要的
successor	n. 接替的人或事物， 继任者
span	n. （桥墩间的）墩距
sober	adj. 未醉的，有节制的；严肃的，持重的；素淡的，暗淡的 v. 醒酒， 清醒
concept	n. 概念， 观念； 设想
radiate	v. 发出， 辐射； 流露， 显示
protest	v. ['prəutest] n. 抗议， 反对
meadow	n. 草地
smash	vi. 猛撞，猛冲 vt. 使粉碎，使打烂；狠打，猛击；使破灭，使失败 n. 破碎； 猛击， 猛撞； 轰动的演出， 巨大的成功
grieve	vi. 感到悲痛，伤心 vt. 使伤心， 为…而伤心
valve	n. 阀， 活门； 瓣膜， 活瓣
imaginative	adj. 富有想象力的， 爱想象的
electrical	adj. 电的； 电气科学的
cane	n. 手杖； 茎
remedy	n. 补救办法，纠正办法；药品，治疗法 vt. 补救， 纠正； 医治， 治疗
radius	n. 半径， 半径范围
retort	v. 反击；反驳
dean	n. （大学）院长，系主任
suffice	vi. 足够
dazzle	v. 使目眩；使倾倒
tow	n&vt. 拖， 拉， 牵引
brink	n. 边缘， 边沿
assume	vt. 假定， 假设； 臆断； 承担， 担任； 呈现
threaten	v. 威胁， 恐吓； 预示快要来临； 构成威胁， 可能发生
object	vi. 反对， 不赞成 n. 实物， 物体； 目的， 目标； 对象， 客体； 宾语
guarantee	n. 保证，担保物 vt. 保证， 担保
refute	vt. 驳斥， 驳倒
installment	n. 分期付款， 分期交付； 部分
verbal	adj. 口头的； 用言辞的， 用文字的； 动词的
barricade	n. 路障，栅栏，障碍 vt. 设路障于， 挡住
stroll	n&vi. 散步， 闲逛
decency	n. 得体；宽容，大方；正派，合乎礼仪，体面；
salvation	n. 拯救， 解救； 解救措施
discreet	adj. 谨慎的， 慎重的， 审慎的
fantastic	adj. 极好的， 极出色的； 了不起的； 极大的； 难以相信的； 异想天开的， 不实际的； 奇异的， 古怪的
fulfill	vt. 履行， 实现， 完成； 满足， 使满意
credit	v. 相信，信任 n. 相信，信任
mass	adj. 大量的，大规模的 v. 聚集， 集中 n. 众多，大量；团，块，堆；群众；质量
scatter	vt. 撒， 散播； 使散开， 驱散
wardrobe	n. 衣柜； 全部衣物
attach	vt. 缚， 系， 贴， 附加； 使依恋， 使喜爱； 使附属； 认为有
decorate	vt. 装饰， 装潢， 修饰
induce	vt. 引导， 劝； 引起， 导致
cynical	adj. 愤世嫉俗的， 怀疑的
identify	vt. 认出， 鉴定； 把…等同于
comet	n. 彗星
render	vt. 使得， 致使； 给予， 提供； 翻译
insight	n. 洞察力； 洞悉， 深刻的见解
ascend	vi. 渐渐上升，升高 vt. 攀登， 登上
reconciliation	n. 和解， 调和
perch	n. （禽鸟的）栖木
unanimous	adj. 全体一致的， 一致同意的
token	adj. 象征性的， 装样子的 n. 筹码；信物，标志，纪念品；代金券，礼券
competitive	adj. 竞争的， 比赛的； 好竞争的， 求胜心切的； 有竞争力的
stitch	v. 缝， 绣 n. 一针，线迹；缝法，针法，编结法；突然剧痛
band	n. 乐队；群，伙；带；条纹；波段 vt. 用带绑扎
consolidate	v. 巩固， 加强； 联为一体， 合并
hazardous	adj. 危险的； 冒险的
fellowship	n. 伙伴关系， 交情， 友谊； 团体， 协会， 联谊会； 奖学金， 研究员职位
tolerant	adj. 宽容的， 容忍的
orthodox	adj. 传统的； 正统的， 正宗的
recycle	vt. 回收利用
apt	adj. 易于…的， 有…倾向的； 恰当的， 适宜的； 聪明的， 反应敏捷的
fixture	n. 固定装置； 固定在某位置的人
preparatory	adj. 预备的
superior	adj. 上级的，较高的；优越的；有优越感的，高傲的 n. 上级， 长官
blunt	adj. 钝的；率直的，直言不讳的 vt. 使迟钝； 使减弱； 使钝
depression	n. 抑郁， 沮丧； 不景气， 萧条； 洼地， 凹陷
chip	n. 屑片， 碎片； 炸土豆条； 集成电路片， 集成块； 缺口， 瑕疵
presume	vi. 擅自行事 vt. 推测，假定，相信；冒昧，擅自；认定，推定
consistent	adj. 坚持的， 一贯的； 一致的， 符合的
neglect	n&vt. 忽视， 忽略； 疏忽
rarely	adv. 不常， 难得
crowd	vi. 聚集， 挤， 涌 n. 群，一批 vt. 挤；挤满
appliance	n. 用具， 器具， 器械
latitude	n. 纬度； 纬度地区； 回旋余地， 自由
compromise	v. 妥协； 危及； 放弃 n. 妥协，和解；折中办法
complain	vi. 抱怨， 诉苦； 控告， 投诉
vicious	adj. 恶毒的， 凶残的； 剧烈的， 严重的
evil	adj. 坏的 n. 邪恶，祸害
measurement	n. （量得的）尺寸，大小
fund	n. 资金，基金；存款 vt. 为…提供资金
marginal	adj. 微小的， 少量的； 不重要的； 仅以微弱多数票获胜的； 记在页边的， 有旁注的
mild	adj. 味淡的
impair	vt. 损害， 损伤； 削弱
syndrome	n. 综合病症， 综合症状； 一系列表现
precedent	n. 先例， 范例； 【法】 判例； 惯例
eastward	adv. 向东
force	vt. 强迫；用力推动，用力打开 n. 军队， 兵力； 暴力， 武力； 力， 力气； 影响力， 效力
refresh	v. 振作精神， 恢复活力
contention	n. 论点； 争论， 争辩
definitive	adj. 最可靠的， 权威性的； 决定性的
confirm	vt. 证实， 肯定； 确认； 批准
frequent	adj. 时常发生的， 常见的
status	n. 地位， 身份； 情形， 状况
lump	v. （使）成团，结块
miniature	adj. 小型的，微小的 n. 微小的模型， 缩影； 微型画， 微型人物像
insert	v. 插入，放进
melody	n. 旋律， 曲调； 悦耳的音乐
mutter	n&v. 轻声低语； 小声抱怨
undermine	vt. 暗中破坏， 逐渐削弱； 侵蚀…的基础
sympathy	n. 同情； 一致； 支持， 赞同
assign	vt. 指派， 分配； 布置； 指定
obscene	adj. 淫秽的， 下流的； 可憎的， 可恶的
brood	vi. 沉思，考虑；孵蛋 n. 一窝； 全体孩子
default	n. 不履行义务 v. 不履行义务
clutch	vi. 企图抓住 vt. 抓紧，紧握 n. 离合器； 掌握， 控制； 把握， 抓紧
cellar	n. 地窖， 地下室； 酒窖
preliminary	adj. 预备的，初步的 n. 初步做法， 起始行为
retrospect	n. 回顾
decisive	adj. 决定性的； 坚定的， 果断的， 决断的
vulnerable	adj. 易受伤的， 脆弱的； 易受攻击的， 难防御的
suspicious	adj. 猜疑的， 疑心的； 可疑的； 表示怀疑的
purify	vt. 使纯净， 提纯； 使纯洁
permanent	adj. 永久的， 固定的
religion	n. 宗教， 宗教信仰
uphold	vt. 支持， 维护
descent	n. 下降， 下倾； 斜坡， 坡道； 血统， 世系
furnish	vt. 供应， 提供； 装备
pistol	n. 手枪
romance	n. 恋爱， 恋爱关系； 浪漫气氛， 传奇色彩； 爱情小说， 传奇故事
fertile	adj. （创造力）丰富的
dominate	v. 在…中占首要地位； 支配， 统治； 耸立于， 俯视； 拥有优势
worthy	adj. 有价值的， 值得的
transition	n. 过渡， 转变
instrumental	adj. 起作用的， 有帮助的； 用乐器演奏的
transmission	n. 传播， 发射； 传送， 传递； 传染
clearing	n. （森林中的）空旷地
strand	n. 股，缕；一个组成部分 vt. 使搁浅
monetary	adj. 钱的， 货币的； 金融的
contaminate	vt. 弄脏， 污染
intellectual	adj. 智力的 n. 知识分子
isle	n. 小岛， 岛
estate	n. 地产， 房地产
exquisite	adj. 精美的， 精致的； 敏锐的， 有高度鉴赏力的； 剧烈的， 感觉强烈的
owe	vt. 欠； 应把…归功于； 感激， 感恩
authoritative	adj. 有权威性的， 可信的； 专断的， 命令式的
flat	adv. 平直地； 直截了当地 adj. 平的；固定的；漏气的；单调的，沉闷的；浅的 n. 一套房间，单元住宅
venture	vi. 冒险； 大胆行事 n. 风险投资，风险项目 vt. 拿…冒险；敢于
offensive	adj. 冒犯的，无礼的，使人不快的；进攻的，攻击性的 n. 进攻， 攻势
limitation	n. 限制， 限度； 局限
artificial	adj. 人工的， 人为的； 矫揉造作的； 模拟的
blur	v. 变模糊 n. 模糊，模糊的东西
moreover	adv. 而且， 再者， 此外
muddy	adj. 泥泞的，沾满烂泥的；灰暗的，暗淡的；模糊的，糊涂的 vt. 使沾上烂泥； 使显得扑朔迷离
menace	n. 威胁 v. （进行）威胁
cucumber	n. 黄瓜
whereas	conj. 然而， 但是， 尽管
symbol	n. 象征； 符号， 标志
transplant	vt. 移栽，移种；移植；使迁移，使移居 n. 移植
alloy	n. 合金 vt. 将…铸成合金
register	v. 登记， 注册； 指示， 自动记下； 表示， 表达； 注意到， 记住； 把挂号 n. 登记，注册；登记表，注册簿
mistress	n. 情妇； 主妇， 女主人
creation	n. 创造， 创建； 创造的作品， 产物； 宇宙， 天地万物
champagne	n. 香槟酒
retention	n. 保留， 保持
climate	n. 气候； 风土， 地带； 风气， 气氛
denounce	vt. 谴责， 指责； 告发
sieve	n. 筛子，漏勺 vt. 筛， 滤
illegal	adj. 不合法的， 非法的
precipitate	v. 使突然发生； 猛然抛下； 使沉淀
circus	n. 马戏， 马戏团； 喧闹的场面； 环形广场
achievement	n. 完成； 成就， 成绩
burial	n. 葬， 掩埋； 葬礼
reluctant	adj. 不情愿的， 勉强的
cute	adj. 漂亮的， 娇小可爱的； 聪明伶俐的， 精明的
susceptible	adj. 易受影响的； 过敏的； 能经受的， 容许的
reel	vi. 摇摇晃晃地移动，蹒跚；眩晕，发昏 n. 卷轴，卷筒，卷盘 vt. 卷， 绕
feast	vi. 尽情地吃， 宴饮； 参加宴会 n. 盛宴，筵席；节日
prejudice	n. 偏见，成见 vt. 使有偏见； 对…不利， 损害
partial	adj. 部分的； 不公平的； 偏爱的， 偏袒的
administration	n. 管理； 管理部门， 行政机关； 实行， 执行
rebel	vi. 反叛， 造反； 反对， 不服从 n. 反叛分子，反对者
management	n. 管理； 处理； 管理部门， 管理人员
naive	adj. 幼稚的； 天真的； 轻信的
paradise	n. 天堂， 乐园
quarterly	adv. 按季度，一季一次 adj. 季度的，每季一次的 n. 季刊
negligible	adj. 可忽略不计的， 微不足道的
constrain	vt. 限制， 约束； 克制， 抑制
prophet	n. 先知； 预言者
gasp	vi. 喘气，倒抽气 vt. 喘着气说出 n. 喘气， 倒抽气
plea	n. 恳求， 请求； 抗辩， 答辩， 辩护； 借口， 托辞
volume	n. 卷， 册， 书卷； 容积， 体积； 音量， 响度
texture	n. 质地； 结构
tick	vi. 发出滴答声 n. 记号，勾号；滴答声 vt. 给…标记号
exempt	adj. 被免除的， 被豁免的 vt. 免除，豁免
virtue	n. 善， 美德； 优点， 长处
shipment	n. 装运， 装船； 装载的货物
enlightenment	n. 启发， 开导； 开明， 文明
obstacle	n. 障碍， 障碍物； 妨害
exceedingly	adv. 极端地， 非常
disturbance	n. 扰乱， 打扰； 骚乱， 混乱； 心神不安， 烦恼
sentiment	n. 意见， 观点； 感情， 情绪
cozy	adj. 舒适的； 亲切友好的
objection	n. 反对， 异议； 反对的理由
correspondence	n. 信件， 函件； 通信， 通信联系； 符合， 一致， 相似
bud	vi. 发芽， 萌芽 n. 花蕾，叶芽
alter	vt. 改变， 变更， 变动
fatigue	v. 疲劳 n. 疲劳，劳累
engage	vt. 使从事于， 聘用； 吸引， 占用； 使订婚
giggle	n. 咯咯笑， 傻笑
veil	n. 面纱，面罩；遮盖物，掩饰物 vt. 掩盖， 掩饰
yoke	n. 牛轭；束缚，枷锁 vt. 结合， 联结
humidity	n. 湿度， 潮湿， 湿气
personality	n. 人格， 个性； 人物
swap	n&v. 交换
whirl	vi. 旋转，急转；发晕，变混乱 n. 旋转， 回旋； 混乱； 一连串的事
reserve	vt. 保留，留存；预订 n. 储备； 保留； 拘谨， 矜持； 替补队员； 后备部队； 自然保护区
merely	adv. 仅仅， 只不过
hatch	vt. 孵出；筹划， n. 舱门； 开口； 孵化
estimate	vt. 估计； 评价 n. 估计； 评价； 看法
idiot	n. 白痴； 傻子， 笨蛋
expectancy	n. 预料； 期待； 盼望
lash	v. 将系牢；鞭打，抽打；猛烈打击；猛烈抨击，严厉斥责 n. 鞭打； 假睫毛； 鞭梢
herb	n. 药草， 香草； 草本植物
multiple	adj. 复合的；多重的，多样的 n. 倍数
crash	vi. 倒下，坠落；发出撞击声；垮台，破产 vt. 碰撞，砸碎；冲，闯 n. 碰撞； 破裂声
procedure	n. 程序； 手续； 步骤
challenge	n. 挑战，邀请比赛；艰巨的任务；怀疑，质问 vt. 反对， 公然反抗； 向…挑战； 对…质疑
contribute	v. 捐献， 捐款； 投稿
certainty	n. 必然的事， 确定的事实； 确信， 确实
memorize	vt. 记住， 熟记
comic	adj. 喜剧的，滑稽的 n. 连环漫画； 喜剧演员
minibus	n. 小型公共汽车
heap	n. 堆， 大量
exceptional	adj. 优越的， 杰出的； 例外的， 独特的， 异常的
abortion	n. 流产， 堕胎
lace	n. 网眼花边，透孔织品；鞋带，系带 vt. 用系带束紧
contrast	vi. 形成对比， 对比之下显出区别 n. 对比，对照；反差[kən'trɑːst] vt. 对比，对照
sour	adj. 酸的；馊的，酸味的；脾气坏的 v. 变酸， 变馊； 变得乖戾
interact	vi. 相互作用， 相互影响
van	n. 大篷车， 运货车
imperial	adj. 帝国的， 帝王的； 英制的
species	n. 种， 类
dazzle	vt. 使眩目，耀；使赞叹不已；使倾倒 n. 耀眼的光； 令人赞叹的东西
probability	n. 可能性， 可能发生的事； 概率
inflict	vt. 把…强加给； 使…遭受， 使…承担
crisp	adj. 脆的，鲜脆的；挺括的；清新的，干冷的；简明扼要的，利落的 n. 油炸土豆片
revolutionary	adj. 革命的；革新的 n. 革命者
flask	n. 长颈瓶， 酒瓶， 烧瓶
jeopardize	vt. 危及， 危害
safeguard	vt. 保护，维护 n. 预防措施； 保证条款
legitimate	adj. 合情合理的；合理的，法律认可的 vt. 使合法
beyond	adv. 在更远处， 再往后 prep. 在…的那边，远于；迟于；越出
ascribe	vt. 把…归因于， 把…归属于
minority	n. 少数； 少数民族
committee	n. 委员会， 全体委员
senator	n. 参议员
pitch	v. 投掷， 使猛然倒下； 表达， 定下特定程度； 定调； 架设， 搭， 扎； 颠簸 n. 球场；程度，强度；高度，高音；沥青
moan	vi. 呻吟，呜咽；抱怨，发牢骚 vt. 抱怨 n. 呻吟声， 呜咽声； 怨声， 牢骚
morality	n. 道德， 道德性； 德行， 品行； 道德观， 道德规则
relief	n. 轻松， 宽慰； 缓解， 减轻， 解除； 使得到调剂； 接替， 替下
exemplary	adj. 可作楷模的， 典范的
correlate	vi. 相关， 关联 vt. 使相互关联
therefore	adv. 因此， 所以
dentist	n. 牙科医生
petition	v. 请愿， 正式请求 n. 请愿书，申请书；诉状
clerk	n. 店员； 办事员， 职员
credit	n. 信贷，赊欠；赞扬，荣誉；学分；信任 vt. 相信； 把…记入贷方； 把…归于
questionnaire	n. 问卷， 征求意见表
component	adj. 组成的， 构成的 n. 组成部分，部件，组件
security	n. 安全， 保障； 抵押品； 证券
cape	n. 斗篷， 披肩； 海角， 岬
disperse	vi. 分散， 赶散； 消散， 驱散 vt. 使分散，散开；使消散，消失
coupon	n. 礼券， 优惠券； 配给券， 票证
superficial	adj. 表面的， 肤浅的
shutter	n. 百叶窗； 快门
multiply	v. 增加， 繁殖； 乘
loyal	adj. 忠诚的， 忠心的
lofty	adj. 高傲的， 傲慢的； 崇高的， 高尚的； 高耸的， 极高的
propel	vt. 推进， 推动； 激励， 驱使
regenerate	vi. 新生， 再生， 起革新作用 vt. 使新生，重建，改革，革新
assassination	n. 刺杀， 暗杀
positive	adj. 确实的， 明确的； 积极的， 肯定的
combine	v. 结合，联合；化合 n. 联合企业； 联合收割机
immense	adj. 广大的， 巨大的； 无限的
shield	n. 防护物，护罩；盾 vt. 保护， 防护
forthcoming	adj. 即将到来的； 可得到的； 乐于提供消息的
drill	v. 钻， 打； 训练 n. 钻头；操练，训练
perspective	n. 视角， 观点； 远景， 景观； 透视画法， 透视图
threshold	n. 门槛， 门口； 入门， 开端， 起始点
practicable	adj. 可行的， 适用的
expend	vt. 花费， 消费； 消耗
hoarse	adj. （声音）嘶哑的
specialize	vi. 专攻，专门研究 vt. 使适应特殊目的， 使专用于
incur	vt. 招致， 引起； 遭受
provocative	adj. 挑衅的， 煽动的， 刺激的； 挑逗的
conversion	n. 转变， 变换； 改变信仰， 皈依
agony	n. 痛苦， 苦恼
conventional	adj. 普通的； 习惯的， 常规的； 因循守旧的
rival	adj. 竞争的，对抗的 n. 竞争对手，敌手；可与匹敌的人 vt. 与…竞争； 与…匹敌， 比得上
ongoing	adj. 持续的， 继续的
project	v. 伸出； 投射； 放映 n. 方案， 计划； 课题， 项目； 工程
enroll	vi. 入学，加入 vt. 招收， 吸收
kidnap	n. 绑架， 诱拐
apparatus	n. 器械， 器具， 仪器； 机构， 组织
millionaire	n. 百万富翁， 大富翁
erosion	n. 腐蚀， 侵蚀， 磨损； 削弱， 减少
boring	adj. 令人厌烦的， 乏味的， 无聊的
inferior	adj. 下等的，劣等的 n. 下级， 下属
remote	adj. 遥远的， 偏僻的； 关系疏远的； 脱离的； 绝少的； 微乎其微的； 孤高的， 冷淡的
despite	prep. 不管， 不顾
realization	n. （理想等的）实现
presumably	adv. 大概， 可能， 据推测
coarse	adj. 粗的， 粗糙的； 粗劣的； 粗俗的
processing	n. 处理
warfare	n. 战争； 斗争， 冲突
mortgage	n. 抵押，抵押借款 vt. 抵押
liable	adj. 易于…的， 可能的
verify	vt. 证实， 查证， 证明
doctrine	n. 教义， 教条； 主义
composite	adj. 混合成的，综合成的 n. 合成物； 复合材料
settlement	n. 解决； 协议； 居留地， 小社区
patent	adj. 专利的，受专利保护的 n. 专利，专利权 vt. 得到…的专利权
siege	n. 包围， 围困
evident	adj. 明显的， 明白的
feature	n. 特征，特色；面貌；特写，专题节目；故事片 vt. 突出； 由…主演
formula	n. 公式， 式； 原则， 方案； 配方
simulate	vt. 模仿， 模拟； 假装， 冒充
disguise	vt. 假扮，化装，伪装；掩盖，掩饰 n. 用来伪装的东西； 伪装， 掩饰
divorce	n. 离婚，离异 vt. 离婚； 分离， 脱离
slap	vt. 掴，掌击，拍；啪的一声放 n. 掴， 掌击， 拍
withdraw	v. 收回， 撤回； 撤退
agenda	n. 议程
environment	n. 环境； 外界； 围绕
coward	n. 胆小鬼， 懦夫
terrific	adj. 极妙的； 极大的； 令人恐惧的
legislation	n. 法律， 法规； 立法， 法律的制定
volunteer	v. 自愿； 自愿提供； 志愿 n. 志愿者；志愿兵
remain	vi. 剩下，余留，保持；仍然是 n. 残余； 残骸； 遗迹
invalid	adj. 无效的，作废的；无可靠根据的，站不住脚的 n. 病弱者， 残疾者
extract	vt. 取出，抽出；采掘，提炼，榨取；获得，索取；摘录['3kstrækt] n. 摘录， 选段； 提出物， 精， 汁
magnificent	adj. 壮丽的， 华丽的； 极好的
amplify	vt. 放大， 增强； 扩大； 详述， 进一步阐述
flush	vi. 发红 adj. 齐平的， 同高的
contradict	vt. 反驳， 否认…的真实性； 与…发生矛盾， 与…抵触
negative	adj. 否定的，消极的；负的，阴性的 n. 负片， 底片； 负数
indefinite	adj. 无限期的； 模糊的， 不确定的
congress	n. 代表大会； 国会， 议会
ammunition	n. 弹药， 军火
utopian	adj. 乌托邦的； 理想的
ferry	n. 渡船 vt. 渡运
ore	n. 矿， 矿石
mercury	n. 水银， 汞
engine	n. 引擎， 发动机； 机车
accomplish	vt. 达到， 完成
fascinate	vt. 强烈地吸引， 迷住
transform	vt. 使改观， 改革； 变换， 把…转换成
abandon	vt. 离弃， 丢弃； 遗弃； 抛弃； 放弃
defy	vt. 违抗， 蔑视； 使成为不可能； 惹， 激
extensive	adj. 广阔的； 广泛的
access	n. 接近；通道，入口；接近的机会 vt. 存取
incline	n. 斜坡[In'klaIn] vt. 使倾斜
hesitate	vi. 犹豫， 踌躇， 含糊； 不情愿
describe	vt. 形容， 描写； 画出
extinguish	vt. 熄灭， 扑灭； 使消亡， 使破灭
junction	n. 联结点， 交叉点， 枢纽
insulate	vt. 使绝缘， 使隔热， 使隔音； 隔离， 使隔绝
academic	adj. 学院的；学术的；纯理论的，不切实际的 n. 大学教师
partition	n. 分隔物，隔墙；分割，划分 vt. 隔开； 分割， 瓜分
dizzy	adj. 头晕目眩的，眩晕的；头晕的 vt. 令人发晕
splash	v. 溅，泼 n. 溅泼声； 溅出的水； 斑点
individual	adj. 个别的；独特的 n. 个人， 个体
ascertain	vt. 弄清， 查明； 确定
destination	n. 目的地， 终点； 目标
design	vt. 设计；预定，指定 n. 设计， 构想； 图样； 企图
eagle	n. 鹰
alert	adj. 警觉的，留神的，注意的 vt. 使认识到，使意识到 n. 警戒， 戒备； 警报
pastry	n. 油酥面团， 酥皮糕点
scandal	n. 丑事， 丑闻； 流言蜚语； 反感， 愤慨
rim	n. 边，缘 vt. 环绕边缘
interpersonal	adj. 人与人之间的， 关于人与人之间关系的
brutal	adj. 野兽般的， 残忍的； 无情的， 冷酷的， 难以忍受的
random	adj. 任意的， 随机的
proposition	n. 论点， 主张； 建议， 提案； 命题
brilliant	adj. 光辉的； 卓越的
calorie	n. 大卡； 卡
tunnel	v. 挖， 开 n. 隧道，坑道，地道
rally	v. 集合
critical	adj. 决定性的； 批评的
knit	vi. 编结， 编织； 愈合 vt. 编结，编织；使紧密地结合，使紧凑；皱紧，皱
refuge	n. 庇护所， 避难处； 庇护
twist	v. 缠绕，盘绕；转动，旋动；捻，搓；歪曲，曲解；扭歪，扭伤；曲折前进；转身 n. 扭弯； 转折， 转变； 弯曲， 曲折处
booth	n. 小房间， 公用电话亭， 岗亭； 售货棚， 货摊
shaft	n. 柄， 杆； 束， 光线； 轴； 竖井， 升降井
disperse	v. （使）分散；驱散
haunt	vt. 常出没于；使苦恼，使担忧；萦绕在心头，缠绕 n. 常去的地方
climax	n. 顶点
entreat	v. 恳求
enthusiastic	adj. 满腔热情的， 热心的， 极感兴趣的
rhythm	n. 韵律， 节奏
distill	vt. 蒸馏， 用蒸馏法提取； 吸取， 提炼
articulate	adj. 善于表达的， 发音清晰的； 表达得清楚有力的 vt. 明确有力地表达； 清楚地吐， 清晰地发
electron	n. 电子
frustration	n. 挫败， 挫折， 受挫
quiver	v. （轻微地）颤动
ultraviolet	adj. 紫外的
napkin	n. 餐巾
comparable	adj. 可比较的； 类似的； 比得上的
principle	n. 原则， 原理， 道义； 基本信念， 信条
evidence	n. 根据， 证据； 证人
embed	vt. 把…嵌入， 扎牢； 使深留脑中
predominant	adj. 占主导地位的， 显著的
subsidy	n. 津贴， 补助金
exert	vt. 用， 尽； 运用， 行使
versus	prep. （比赛等中）对
compulsory	adj. 必须做的， 强制性的； 必修的
scent	n. 香味，气味；臭迹；踪迹，线索；香水 vt. 嗅到， 察觉
premier	adj. 首要的， 首位的， 首次的 n. 总理，首相
tangle	v. 缠结，乱作一团 n. 乱糟糟的一堆， 混乱； 复杂的问题； 困惑
devote	vt. 将…奉献给， 把…专用
remainder	n. 余下的部分， 剩下的人数
collaboration	n. 合作， 协作； 勾结
layer	n. 层， 层次
falsehood	n. 谬误， 虚假； 谎言， 说谎
lens	n. 透镜， 镜片； 镜头
alternative	adj. 两者选一的， 供选择的； 另类的 n. 替换物，选择；选择的自由
pretext	n. 借口， 托辞
suburb	n. 郊区， 郊外， 近郊
exhibit	vt. 显示；陈列，展览 n. 展览品
autonomy	n. 自治， 自治权； 人身自由， 自主权
rip	v. 扯破，撕坏 n. 裂口， 裂缝
furious	adj. 狂怒的， 暴怒的； 强烈的， 激烈的
discipline	n. 纪律，训练；惩罚；学科 vt. 训练； 惩罚， 处罚
literary	adj. 文学的； 文人的， 书卷气的
metropolitan	adj. 大都市的， 大都会的； 首都的
facilitate	vt. 使…变得容易， 使便利
toxic	adj. 有毒的， 因中毒引起的
glide	n. 滑行， 滑动； 滑翔
rejoice	vi. 感到高兴， 充满喜悦
magnetic	adj. 磁的； 有吸引力的
foresee	vt. 预见， 预知
accuse	vt. 指责， 归咎于
predict	vt. 预言， 预告， 预测
conspicuous	adj. 显眼的， 明显的
spiral	vi. 盘旋上升； 不断急剧地上升 adj. 螺旋的 n. 螺旋，螺旋式的上升
conserve	vt. 保护， 保藏， 保存
champion	n. 冠军， 得胜者； 捍卫者， 拥护者
posture	vi. 摆出姿势， 装模作样 n. 姿势，姿态；看法，态度
obligation	n. 义务， 责任
distinguish	vt. 区别， 辨别， 识别； 使杰出； 使著名
fossil	n. 化石； 食古不化的人， 老顽固
anxiety	n. 焦虑， 忧虑； 渴望， 热望
dome	n. 圆屋顶， 穹顶
foul	adj. 难闻的，发臭的；令人不愉快的，糟透了的；污浊的，肮脏的；下流的，辱骂性的；恶劣的，有暴风雨的；邪恶的，罪恶的 vt. 对…犯规；弄脏，弄污 n. 犯规
symmetry	n. 对称； 匀称， 整齐
reception	n. 招待会， 欢迎会； 接受， 接纳； 接待， 迎接； 接收效果
consumer	n. 消费者， 用户， 消耗者
submarine	adj. 水底的， 海底的 n. 潜水艇
concentrate	v. 浓缩，提浓
hoe	v. 锄地
magnify	vt. 放大， 扩大； 夸大， 夸张
bully	n. 恃强欺弱者 vt. 威吓， 欺负
nickel	n. 镍； 五分镍币， 五分钱
medium	adj. 中等的 n. 媒质，媒介物；传导体
sneer	v. 冷笑；嘲笑 n. 冷笑；嘲笑
prosperous	adj. 繁荣的， 兴旺的
originate	vi. 起源于，来自，产生 vt. 创造， 创始， 开创
hawk	n. 鹰，隼；“鹰派”人物 vt. 叫卖， 兜售
scoff	v. 嘲笑，嘲弄
propaganda	n. 宣传
instance	n. 例子， 实例， 事例
exception	n. 例外， 除外
subjective	adj. 主观的， 个人的
cite	vt. 引用， 引证； 传唤， 传讯； 表彰， 嘉奖
compute	v. 计算， 估算
luggage	n. 行李
grope	v. （暗中）摸索，探索
surpass	vt. 超过， 优于， 多于； 超过…的界限， 非…所能办到
violent	adj. 暴力引起的， 强暴的； 猛烈的， 剧烈的
adequate	adj. 足够的； 可以胜任的
rational	adj. 理性的， 理智的； 合理的
hazard	n. 危险，公害 vt. 尝试着做， 冒…风险
pop	v. （意外地）出现
configuration	n. 配置， 布局， 构造
criterion	n. 标准， 准则
humanity	n. 人类， 人； 人性； 人道， 博爱； 人文学科
resolve	v. 决定；解决；分解 n. 决心
slick	adj. 圆滑的， 口齿伶俐的； 精巧的， 巧妙的， 灵巧的； 光滑的， 滑溜的
potential	adj. 潜在的，可能的 n. 潜力， 潜能
cathedral	n. 大教堂
generous	adj. 慷慨的， 宽厚的； 大量的
deport	vt. 把…驱逐出境
pedal	vi. 踩踏板，骑车 n. 踏板，踏脚 vt. 脚蹬， 踩动…的踏板
inferiority	n. 自卑； 次等
utilize	vt. 利用
refund	n. 退款 vt. 退还
fantasy	n. 想象， 幻想； 想象的产物
flaw	n. 缺点， 瑕疵， 缺陷
assumption	n. 假定， 臆断； 担任， 承担
dole	n. 救济，救济金 vt. 发放， 发给
pamphlet	n. 小册子
activate	vt. 使活动起来； 使开始作用
deliberate	adj. 故意的， 蓄意的； 慎重的， 深思熟虑的 v. 仔细考虑， 思考
acid	adj. 酸的， 酸性的； 尖刻的， 刻薄的 n. 酸
hysterical	adj. 情绪异常激动的， 歇斯底里般的
suppress	vt. 压制， 镇压； 禁止发表， 查禁； 抑制， 忍住； 阻止…的生长
inject	vt. 注射， 给…注射； 注入， 引入， 投入
denote	vt. 意思是； 表示， 是…的标志
sticky	adj. 黏性的， 胶粘的； 湿热的
accident	n. 意外， 事故
garbage	n. 垃圾， 废物； 废话； 无用的资料
nil	n. 无， 零
version	n. 译文， 说法， 改写本
resistant	adj. 抵抗的； 抗…的， 耐…的
deferential	adj. 恭敬的， 恭顺的
survival	n. 幸存； 幸存者； 残存物
wax	n. 蜡，蜂蜡 vt. 给…上蜡
inventory	n. 详细目录， 存货清单
overhear	vt. 无意中听到， 偷听到
cabinet	n. 橱， 柜； 内阁
materialism	n. 唯物主义
deem	vt. 认为， 视为
uneven	adj. 不平坦的， 不平滑的； 不一致的， 不相等的
economic	adj. 经济的；经济学的 n. 经济学； 经济状况
accord	v. 相符合， 相一致， 相和谐； 授予， 赠与， 给予 n. 一致，符合；谅解，协议
occupy	vt. 占领； 占； 占有
reputation	n. 名誉， 名气， 名声
commit	vt. 犯， 干； 使承诺； 把…托付给； 调拨…供使用， 拨出
theft	n. 偷窃， 失窃
exposition	n. 阐述， 讲解； 展览会， 博览会
controversy	n. 争论， 辩论
survey	v. 俯瞰， 眺望； 全面审视， 调查； 测量， 勘定 n. [sə'veɪ]
contest	n. 竞赛， 争夺 vt. 争夺， 与…竞争； 对…提出质疑， 辩驳
entail	vt. 使承担； 使成为必要， 需要
communicate	v. 通讯， 交际， 交流； 连接， 相通； 传达， 传播； 传染
recovery	n. 恢复， 痊愈； 追回， 寻回， 收复
cognitive	adj. 认知的， 认识能力的
calculate	v. 计算， 推算； 计划， 打算
repertoire	n. 全部节目
wreck	n. 失事，残骸；精神或身体已垮的人 vt. 破坏
feasible	adj. 可行的， 可能的
finance	n. 财政，金融；财源，财务情况 vt. 为…提供资金
culture	n. 文化， 文明； 教养； 培养； 培养菌
despise	vt. 鄙视， 看不起
reverse	vi. 反向，倒转 adj. 反向的； 相反的； 颠倒的 vt. 撤销，废除；使完全相反，彻底转变；使反转，使次序颠倒 n. 相反情况，对立面；反面，背面，后面；损失，倒退
nurture	n&vt. 养育， 培育， 滋养
physiological	adj. 生理的， 生理学的
cocaine	n. 可卡因， 古柯碱
hostage	n. 人质
erupt	vi. 喷发， 喷出； 爆发， 突然发生
envisage	vt. 想象， 设想
donate	vt. 捐赠， 赠送
converge	vi. 会合， 互相靠拢； 聚集， 集中； 趋近
loom	vi. 阴森地逼近， 隐现； 即将来临 n. 织布机
thrill	v. （使）激动
monster	adj. 大的， 庞大的 n. 怪物；极其残酷的人；巨人，巨兽，巨大的东西
watertight	adj. 不透水的， 防水的； 严密的， 无懈可击的
decimal	adj. 十进位的 n. 小数
crew	n. 全体船员； 一队工作人员
traverse	vt. 横渡， 横越
expertise	n. 专门知识， 专长
upright	adv. 挺直着， 竖立着 adj. 垂直的；正直的，诚实的
pest	n. 有害生物， 害虫； 讨厌的人
resign	vi. 辞职；听任 vt. 辞去， 放弃； 使顺从
string	n. 线， 细绳； 一串， 一行
software	n. （计算机的）软件
cereal	n. 加工而成的谷类食物； 谷类植物， 谷物
overflow	vi. 满得外溢，外流，泛滥；充满，洋溢 vt. 淹没， 从…中溢出， 多得无法容纳 n. 容纳不下的物； 溢出， 满出； 溢流口， 溢流管
artery	n. 动脉； 干线， 要道
urban	adj. 都市的， 住在都市的
displace	vt. 取代， 替代； 迫使…离开家园， 使离开原位
temperament	n. 气质， 性格
agent	n. 代理人， 代理商； 政府代表； 动因， 原因； 剂
tickle	vi. 发痒 vt. 使发痒；使高兴，逗乐 n. 痒
rash	adj. 轻率的，鲁莽的 n. 疹， 皮疹； 爆发的一连串
nominal	adj. 名义上的， 有名无实的； 很少的， 象征性的； 名词性的
overlap	v. 部分重叠； 部分相同 n. 重叠， 重叠的部分
reconcile	vt. 使协调； 使和解； 使顺从， 使甘心
remnant	n. 残留部分
galaxy	n. 星系； 银河系， 银河； 一群
statement	n. 陈述， 声明； 结算单， 报表
bust	vi. 爆裂，坏掉 vt. 打破，打碎 n. 胸像， 半身像； 胸部， 胸围
oppress	vt. 压迫， 压制； 使沉重， 使烦恼
crisis	n. 危机， 存亡之际； 关键阶段
tissue	n. 组织； 薄绢， 薄纸， 手巾纸
woe	n. 悲哀，悲痛，苦恼
worthwhile	adj. 值得花时间做的
stock	v. 储备 adj. 常用的， 常备的 n. 原料，库存品；股本，公债；世系，血统；汤汁；家畜，牲畜
attribute	vt. 把…归因于 n. 属性
banquet	n. 宴会， 盛宴
prime	adj. 首要的；最好的 n. 青春；全盛时期 vt. 使准备好
doom	vt. 注定，命定 n. 厄运， 劫数
counsel	n. 律师，法律顾问；忠告，劝告 vt. 劝告， 提议
queer	adj. 奇怪的， 异常的； 不舒服的， 眩晕的
poverty	n. 贫穷， 贫困
diverse	adj. 不一样的， 相异的； 多种多样的
minimum	adj. 最低的， 最小的 n. 最低限度，最小量
shark	n. 鲨鱼； 勒索者， 诈骗者， 放高利贷的人
avert	vt. 防止， 避免； 转移
capacity	n. 容量； 能力； 能量； 才能； 身份， 地位
absence	n. 缺席， 不在； 缺席的时间， 外出期； 缺乏， 不存在
analyse	vt. 分析； 分解， 解析
rectify	vt. 纠正， 修复
invest	v. 投资， 投入； 授予
majesty	n. 陛下； 雄伟， 壮丽； 庄严
semester	n. 学期
gloom	n. 昏暗， 阴暗； 忧郁， 沮丧
vivid	adj. 鲜艳的； 生动的， 栩栩如生的
sculpture	n. 雕刻， 雕塑； 雕刻作品， 雕塑品
optimum	adj. 最合适的， 最优的， 最佳的
cooperative	adj. 有合作意向的，乐意合作的；合作的，协作的 n. 合作社， 合作商店
slippery	adj. 滑的； 狡猾的
deduce	vt. 推论， 推断， 演绎
aspect	n. 方面； 朝向、 方向； 样子， 外表
alarm	n. 惊恐，忧虑，警报 vt. 使惊恐， 使担心
chord	n. 和弦， 和音； 弦， 心弦
vent	n. 通风口，排放口；开衩 vt. 表达， 发泄
racket	n. 喧嚷， 吵闹； 敲诈， 勒索， 诈骗； 球拍
institute	n. 研究所，学院 vt. 建立， 设立
planetary	n. 行星的
elapse	vi. 消逝， 过去
eclipse	n. （日，月）食
eject	vt. 驱逐， 逐出； 喷射， 排出； 弹出
solidarity	n. 团结一致
appraisal	n. 估计， 估量； 评价
alternate	adj. 交替的， 轮流的； 间隔的 v. 轮流， 交替
chunk	n. 厚片， 大块； 相当大的部分
fusion	n. 联合， 合并； 核聚变
conception	n. 思想， 观念， 概念； 构想， 设想； 怀孕
oppose	vt. 反对， 反抗
deceive	vi. 行骗 vt. 欺骗，蒙蔽
fuse	v. 熔合， 合并； 因保险丝熔断而中断工作 n. 保险丝，熔丝；导火线
overturn	vi. 倾覆， 翻转， 翻倒 vt. 使翻转，使倾覆，使倒下；颠覆，推翻
provision	n. 供应； 准备， 预备； 条款， 规定； 给养， 口粮
involvement	n. 连累； 包含
bug	n. 虫子；小病；故障，缺陷；窃听器 vt. 烦扰， 纠缠； 在…装窃听器
detach	vt. 拆卸； 使分开， 使分离
hover	vi. 翱翔； 逗留在近旁， 徘徊； 彷徨， 犹豫
draft	n. 草稿；汇票；征兵；通风 vt. 起草； 征募
supervise	v. 监督，监视
silicon	n. 硅
patrol	v. 巡逻，巡查 n. 巡逻， 巡查； 巡逻兵， 巡逻队
confident	adj. 确信的， 肯定的； 自信的
ecology	n. 生态； 生态学
fling	vt. 扔，掷；使扑，使投身 n. 尽情欢乐的一阵， 一时的放纵
drastic	adj. 严厉的， 极端的； 激烈的， 迅猛的
melt	v. 融化； 溶化； 消散
peak	n. （物体的）尖端
intelligent	adj. 聪明的； 理智的
anniversary	n. 周年
compatible	adj. 兼容的； 能和睦相处的， 合得来的
reveal	vt. 揭露， 泄露； 展现， 显示
unemployment	n. 失业， 失业人数
afflict	vt. 使苦恼， 折磨
tease	vt. 戏弄， 取笑； 挑逗， 撩拨
sip	v. 小口地喝，抿，呷 n. 小口喝， 一小口的量
specification	n. 规格， 规范； 明确说明； 说明书
deteriorate	vi. 恶化， 变坏
pledge	n. 保证，誓言 vt. 保证， 许诺
hardy	adj. 能吃苦耐劳的， 坚强的； 耐寒的
justification	n. 正当的理由， 借口
coverage	n. 新闻报道； 覆盖范围
existence	n. 存在， 实在； 生存
protein	n. 蛋白质
relevant	adj. 有关的， 切题的
retrieve	vi. 重新得到， 取回， 收回； 挽回， 补救； 检索
tremendous	adj. 极大的， 非常的； 精彩的， 了不起的
novelty	n. 新奇事物； 新奇， 新奇感， 新奇性； 新颖小巧而廉价的物品
overpass	n. 天桥， 立交桥
fake	adj. 假的，伪造的 n. 假货；骗子 vt. 伪造， 捏造； 伪装
chatter	v. 喋喋不休 n. 喋喋不休
urge	vt. 鼓励；推进，催促；竭力主张，强烈要求 n. 冲动， 强烈的欲望
outward	adv. 向外地 adj. 外面的，外表的
chase	n&vt. 追逐， 追赶， 追求
embody	vt. 代表， 表现， 体现； 包括； 包含； 收录
abnormal	adj. 反常的， 异常的
misery	n. 痛苦， 苦恼， 苦难； 悲惨的境遇， 贫苦
propagate	v. 繁殖， 增殖； 传播， 宣传， 普及
pave	vt. 铺， 铺筑
caption	n. 说明文字， 字幕
triple	adj. 三部分的，三方的；三倍的，三重的 v. 增至三倍
sophisticated	adj. 老于世故的； 高级的； 精密的， 复杂的； 高雅的
acceptance	n. 接受， 承认； 容忍
notable	adj. 值得注意的，显著的；著名的 n. 名人， 要人
gauge	n. 测量仪表；厚度，直径；规格、尺寸 vt. 估计， 判断； 计量， 度量
mere	adj. 仅仅的， 纯粹的
turbulent	adj. 动荡的， 混乱的； 汹涌的， 狂暴的
stalk	vi. 高视阔步地走 n. 茎，梗，柄 vt. 悄悄地跟踪
testify	vi. 作证，证明；表明，说明 vt. 作证， 证明
commodity	n. 商品， 货物
vertical	adj. 垂直的， 竖式的
circumstance	n. 情况，条件，境遇；
debate	n&v. 争论， 辩论
efficiency	n. 效率； 功效， 效能
variation	n. 变化， 变动， 变异； 变奏
vegetation	n. 植物， 草木
tilt	v. 倾斜，倾侧 n. 倾斜， 倾侧
prominent	adj. 突出的， 杰出的； 突起的； 凸出的
perfection	n. 完美， 完善
depict	vt. 描绘， 描述
manual	adj. 用手的，手工做的 n. 手册， 指南
bibliography	n. 参考书目； 书目
integral	adj. 构成整体所必需的， 基本的
carve	vt. 切， 把…切碎； 雕刻， 刻
alien	adj. 外国的，外国人的；陌生的；性质不同的，不相容的 n. 外国人， 外侨； 外星人
molecule	n. 分子
institution	n. 协会； 制度； 习俗
attain	vt. 达到， 获得； 完成
application	n. 申请， 申请书； 施用， 涂抹； 应用， 实施； 实用性
deny	vt. 否定， 拒绝相信
heave	v. （用力地）举起；抛
disrupt	vt. 使中断； 扰乱
shove	vi. 用力推，挤 vt. 乱推，挤；乱塞，随意放 n. 猛推
appropriate	adj. 适当的，恰当的 vt. 私吞； 拨款供专用
profound	adj. 深度的， 深切的， 深远的； 知识渊博的， 见解深刻的； 深奥的
decompose	v. 腐败；分解
motel	n. 汽车旅馆
toss	vi. 掷钱币来决定；翻来覆去 vt. 扔，抛，掷；猛抬；拌；掷；使摇动，使颠簸 n. 掷钱币来决定； 猛抬头
compile	vt. 汇编； 编制， 编纂
behavior	n. 行为， 举止， 表现
portray	vt. 描写， 描绘； 扮演， 饰演
pursuit	n. 追求， 寻求； 追赶， 追逐； 事， 嗜好， 消遣
solicitor	n. 初级律师， 事务律师
criminal	adj. 犯罪的， 刑事的 n. 犯人，罪犯，刑事犯
adhere	vi. 黏附， 附着； 遵守； 坚持； 追随， 支持
rotary	adj. 旋转的， 转动的
hinge	vi. 以…为转移 n. 铰链 vt. 装铰链
characteristic	adj. 特有的，典型的 n. 特性
gear	n. 齿轮，传动装置，挡；用具，设备，衣服 vt. 使适应， 使适合
donation	n. 捐款， 捐赠物； 捐赠， 赠送
employment	n. 工作； 雇用； 使用
spacious	adj. 宽广的， 宽敞的
budget	v. 规划，安排；编预算 adj. 低廉的， 收费公道的 n. 预算，预算拨款
vicinity	n. 周围地区， 邻近地区
epoch	n. 时期， 时代
vague	adj. 不明确的； 含糊的； 暧昧的
preach	vi. 布道， 说教 vt. 宣讲，布道；竭力鼓吹，宣传
conservative	adj. 保守的，守旧的；不时兴的，传统的 n. 保守的人
nickname	n. 绰号，诨名 vt. 给…起绰号
exemplify	vt. 是…的典型； 例示， 举例证明
chapel	n. 小教堂， 祈祷室
reliable	adj. 可靠的， 可依赖的
pose	v. 造成，引起；提出，陈述；摆姿势；假装，冒充，装腔作势 n. 样子， 姿势
incredible	adj. 不能相信的， 不可信的， 难以置信的； 惊人的
emphasis	n. 强调； 重视； 重要性
tack	n. 平头钉，大头钉；行动方向，方针 vt. 用平头钉钉； 附加， 增补
construct	vt. 建造； 构思 n. 建筑物； 构想； 观念
junk	n. 废旧物品，破烂 vt. 丢弃， 废弃
blank	adj. 空白的；茫然的，无表情的 n. 空白； 空白表格
betray	vt. 背叛， 出卖； 失信于， 辜负； 泄露； 暴露， 显露
concentration	n. 集中； 专注， 专心； 浓缩； 浓度
sparkle	vi. 发光，闪耀，闪烁；活跃，焕发 n. 闪光， 闪耀， 闪烁； 活力， 生气
escort	n. 护卫者，护送者 vt. 护送， 护卫
concern	n. 关切的事，有关的事；关心，挂念；关系，关联；公司，企业 vt. 涉及， 有关； 使关心， 使担心
referee	vi. 当裁判 n. 裁判员；证明人，推荐人；仲裁者，调解者
profess	vt. 表示， 承认； 宣称信仰
catastrophe	n. 大灾难， 灾祸
invariably	adv. 不变地， 始终如一地， 总是
anticipate	vt. 预料， 预期， 期望； 先于…行动， 提前使用
disapproval	n. 不赞成
dwell	vi. 居住
breakdown	n. 垮台， 破裂； 衰竭， 衰弱； 损坏， 故障； 明细， 清单
initial	adj. 最初的，开始的 n. 首字母
dreadful	adj. 糟透了的， 极不合意的； 极端的， 极其大的； 可怕的
consultancy	n. 顾问； 顾问服务公司
reclaim	vt. 要回； 开垦； 回收
kidney	n. 肾， 肾脏
consumption	n. 消耗， 消费； 肺病
sensible	adj. 明智的， 合情理的
hurricane	n. 飓风
henceforth	adv. 从今以后， 从此以后
compensate	v. 补偿， 弥补； 抵消
compare	vt. 比较， 对照； 把…比作
manipulate	vt. 操纵， 控制； 影响； 操作， 使用
relegate	vt. 使降位， 使降级； 把…委托给
executive	adj. 执行的；行政的 n. 执行者
bishop	n. （基督教的）主教
migrant	n. 移居者， 移民； 候鸟， 迁移动物
erroneous	adj. 错误的， 不正确的
trigger	n. 扳机；引起反应的行动 vt. 触发， 引起
axis	n. 轴， 轴线， 中心线； 坐标轴， 基准线
consist	vi. 由…组成； 在于； 一致
poke	vi. 伸出，突出 vt. 戳，捅；用…戳，把…戳向；伸出，突出 n. 戳， 捅
ego	n. 自我， 自己， 自尊
arrange	v. 安排， 准备； 整理
progressive	adj. 前进的； 渐进的； 进行式的
independence	n. 独立； 自主； 自立
division	n. 分， 分割； 部门， 科， 处； 除法
manuscript	n. 手稿， 原稿， 底稿； 手写本
arrest	vt. 逮捕，拘留；停止，阻止；吸引 n. 逮捕， 拘留， 扣留
bulletin	n. 告示，公告，公报
retain	vt. 保留， 保持
courtesy	n. 谦恭有礼； 有礼貌的举止
deficit	n. 赤字， 亏空， 亏损
marble	n. 大理石； 弹子； 弹子游戏
coincide	vi. 同时发生； 相符， 相一致； 位置重合， 重叠
peak	vi. 达到高峰； 达到最大值 adj. 最大值的；高峰的 n. 山顶，顶点，顶峰
disintegration	n. 破裂， 分裂； 瓦解
scratch	v. 抓，搔，扒；刮擦，刻划 n. 抓痕， 划痕； 抓， 搔， 刮
saleable	adj. 适合销售的
classical	adj. 古典的， 经典的
reckon	vt. 认为， 估计； 指望， 盼望； 测算， 测量
oath	n. 誓言， 誓约； 咒骂， 诅咒语
linger	vi. 继续逗留， 留恋徘徊， 继续存留； 缓慢消失
arrogant	adj. 傲慢的， 自大的
reassess	vt. 再评价
successive	adj. 连续的， 接连的
install	vt. 安装， 设置； 使就职， 任命
offense	n. 犯规， 违法行为； 冒犯， 得罪
initiate	vt. 开始， 创造， 发起； 使初步了解； 接纳， 让…加入 n. 新加入组织的人
revenge	n. 报复，报仇 vt. 为…报仇， 报…之仇
intersection	n. 道路交叉口， 交点
destiny	n. 命运； 定数， 天命
confidential	adj. 秘密的， 机密的； 表示信任的； 担任机密工作的
capable	adj. 有能力的， 有才能的
provided	conj. 假如， 若是
contact	n. 接触，联系，交往 vt. 与…接触， 与…取得联系
grip	vt. 握紧，抓牢；吸引住…的注意力 n. 紧握
intact	adj. 完整无缺的； 未经触动的； 未受损伤的
claim	vt. 声称，主张；对…提出要求，索取；使失踪或死亡；需要，值得 n. 要求； 认领； 索赔； 声称， 断言
nonetheless	adv. 尽管如此， 依然， 然而
arena	n. 表演场地， 竞技场； 活动场所
paradox	n. 似乎矛盾而正确的说法； 自相矛盾的人
vary	vi. 变化， 有差异 vt. 改变，使多样化
sightseeing	n. 观光， 游览
liberal	adj. 心胸宽大的， 慷慨的； 自由的， 自由主义的
aware	adj. 知道的， 意识到的
fracture	v. 断裂，折断 n. 裂缝， 裂痕； 折断
excess	adj. 过量的， 额外的 n. 超越，过量，过度['3ks3s]
conclusive	adj. 确实的； 最后的； 决定性的
tile	n. 瓦，瓷砖 vt. 铺瓦于， 贴瓷砖于
ponder	v. 思索， 考虑， 沉思
cancer	n. 癌， 癌症， 肿瘤
enthusiasm	n. 热情， 热心， 热忱； 巨大兴趣
dim	adj. 昏暗的，朦胧的；模糊不清的 v. 变暗淡
spite	n. 恶意，怨恨；不顾 vt. 刁难， 欺侮
cliff	n. 悬崖， 峭壁
visual	adj. 看的， 视觉的
exclaim	vi. 呼喊， 惊叫
limb	n. 肢， 臂， 腿； 树枝
adverse	adj. 不利的， 有害的
batter	v. 连续猛击 n. 面糊
restraint	n. 抑制， 限制， 克制； 约束措施， 约束条件
overt	adj. 公开的， 不隐蔽的
series	n. 一系列， 连续； 丛书， 连续剧
statistics	n. 统计学； 统计表
routine	adj. 例行的， 常规的 n. 例行公事，惯例，惯常的程序
entity	n. 实体， 独立存在体， 实际存在物
psychiatrist	n. 精神科医生， 精神病专家
cholesterol	n. 胆固醇
hose	n. 软管，水龙带 vt. 用软管淋浇
cane	n. （藤等）茎；手杖
oxide	n. 氧化物
murmur	n&v. 小声说； 小声抱怨， 咕哝； 发出连续而低沉的声音
bruise	n. 青肿，挫伤；伤痕，擦痕 vt. 打青， 使受淤伤； 挫伤， 伤害
analysis	n. 分析， 分析报告； 分解， 解析
surgery	n. 外科， 外科手术； 手术室
prosecute	vi. 起诉， 告发 vt. 对…提起公诉，告发，检举；继续从事
overthrow	vt. 推翻，打倒；使终止，摒弃 n. 推翻， 终止， 结束
addict	n. 有瘾的人； 入迷的人 vt. 使成瘾， 使入迷
instrument	n. 仪器， 工具； 乐器
prevalence	n. 流行
inland	adv. 在内地， 向内地 adj. 内陆的， 内地的
veto	n&vt. 否决
leather	n. 皮革； 皮革制品
supplement	n. 增补， 补充； 增刊， 副刊 vt. 增补， 补充
squeeze	v. 压榨，挤 n. 榨取， 勒索
commonplace	adj. 普通的，平庸的 n. 寻常的事物， 平庸的东西
implicit	adj. 不言明的， 含蓄的； 内含的， 固有的； 无疑问的
condense	vt. 使冷凝， 使凝结； 浓缩， 压缩， 简缩
intermittent	adj. 间歇的， 断断续续的
hike	vi. 徒步旅行 n. 徒步旅行；增加，上升 vt. 提高
nasty	adj. 令人讨厌的， 令人厌恶的； 难弄的， 困难的； 严重的， 恶劣的， 险恶的； 下流的， 道德败坏的
arbitrary	adj. 随心所欲的； 专断的
emphasize	vt. 强调， 着重
ensue	vi. 接着发生， 接踵而来， 因而产生
tame	adj. 驯服的，顺从的；沉闷的，乏味的 vt. 制服， 控制并利用； 驯化， 驯服
degrade	vt. 降低…的身份， 有辱…的人格； 使降解， 使退化
conscientious	adj. 认真的， 勤勤恳恳的
expert	adj. 熟练的 n. 专家
calcium	n. 钙
advantage	n. 优点， 优势； 好处
clasp	n. 扣子，钩子；紧抱，紧握 vt. 抱紧， 握紧； 扣住， 扣紧
slump	vi. 大幅度下降，暴跌；突然倒下 n. 萧条期， 低潮
vehicle	n. 车辆， 机动车； 传播媒介， 工具， 手段
biography	n. 传记
sue	v. 控告， 起诉； 要求， 请求
ritual	adj. 作为仪式一部分的； 例行的 n. 仪式；例行公事，老规矩
absurd	adj. 荒谬的， 荒唐的
disregard	vt. 不理会，漠视 n. 忽视， 漠视
sink	n. （厨房内的）洗涤槽
tuck	vt. 把边塞到下面；把…夹入，把…藏入 n. 褶， 裥
masculine	adj. 男性的， 男子的； 男子气的
premise	n. 房屋和地基， 经营场址； 前提， 假设
suspicion	n. 怀疑， 疑心， 猜疑； 一点儿， 少量
victim	n. 牺牲者； 受害者
transistor	n. 晶体管， 晶体管收音机
signal	adj. 显著的， 重大的 n. 信号，暗号；标志，表示 vt. 发信号；标志着
thorn	n. 刺， 荆棘； 带刺小灌木
region	n. 地区， 地带， 区域； 范围， 幅度
format	n. 设计，安排；格式，样式，版式 vt. 使格式化
visa	n. 签证
consent	n&vi. 同意， 赞成
convince	vt. 使确信， 使信服， 说服
professional	adj. 职业的，专业的，专门的 n. 自由职业者， 专业人员
outcry	n. 大声疾呼， 呐喊； 强烈抗议
friction	n. 不和， 抵触； 摩擦
cautious	adj. 十分小心的， 谨慎的
commission	n. 委任状；委员会；佣金，回扣；授权，委托 vt. 委任， 委托
shaft	n. （工具的）柄，杆状物
kernel	n. （果实的）核；谷粒
relieve	vt. 使轻松， 使宽慰； 缓解， 减轻， 解除； 使得到调剂； 接替， 替下
skeptical	adj. 表示怀疑的
subordinate	adj. 下级的，级别低的；次要的，从属的 n. 部属， 下级 vt. 使处于次要地位， 使从属于
velvet	n. 天鹅绒， 丝绒
pyjamas	n. （宽大的）睡衣裤
conservation	n. 保存， 保护， 避免浪费； 守恒
sake	n. 缘故， 理由
trademark	n. 商标， 牌号； 特征， 标记
inertia	n. 不活动， 惰性； 惯性
electrify	vt. 使充电， 使电气化； 使激动， 使兴奋
blush	n&vi. 脸红
yell	n&vi. 号叫， 叫喊
intricate	adj. 错综复杂的， 复杂精细的
deadline	n. 最后期限
prototype	n. 原型
odor	n. 气味
digest	vt. 消化， 领会 n. 文摘
rape	n&vt. 强奸
innumerable	adj. 无数的， 数不清的
hinder	vt. 阻碍， 妨碍
tutor	v. 当…导师， 当…家庭教师 n. 导师；家庭教师，私人教师
destined	adj. 命中注定的， 预定的； 以…为目的地的
discount	n. 折扣 vt. 把…打折扣； 不全信； 漠视， 低估
deflect	v. （使）偏斜
grease	n. 油脂；润滑脂，润滑油 vt. 用油脂涂， 给…加润滑油
inherit	vt. 继承
beforehand	adv. 预先， 事先
supersonic	adj. 超声的， 超音速的
indication	n. 指出， 指示； 迹象， 暗示
psychological	adj. 心理的
ward	n. 病房； 区； 受监护人
impetus	n. 推动， 促进， 刺激； 推动力
neutral	adj. 中立的， 中性的
pendulum	n. 摆， 钟摆； 摇摆不定的事态
inlet	n. 小湾， 水湾； 进口， 入口
poisonous	adj. 有毒的； 恶毒的
royalty	n. 王族； 版税
slack	vi. 懈怠， 懒散 adj. 懈怠的，马虎的；萧条的，清淡的，不活跃的；松的 n. 松弛部分；宽松裤
similar	adj. 相似的， 类似的
assistance	n. 协助， 援助
summit	n. 最高点， 峰顶； 最高级会议
automatic	adj. 自动的； 必然发生的； 无意识的 n. 自动机械
vein	n. 静脉， 血管； 叶脉； 纹理， 纹路； 方式， 风格
historian	n. 历史学家， 史学工作者
groan	vi. 呻吟，抱怨；发出呻吟般的声音 n. 呻吟， 抱怨； 呻吟般的声音
compliment	n. 赞美，恭维；致意，问候 vt. 赞美， 恭维
maximum	adj. 最大的； 最高的； 顶点的 n. 最大量；顶点
privacy	n. 个人自由； 隐私， 私生活， 私事
slash	vt. 砍；大幅度削减 n. 砍， 砍痕； 斜线号
antique	adj. 古时的，古老的 n. 古物， 古玩， 古董
complaint	n. 抱怨， 怨言； 控告
candidate	n. 候选人， 投考者， 申请求职者
output	n. 产量；输出，输出功率 vt. 输出
vitality	n. 活力； 生机， 元气
decent	adj. 像样的， 过得去的， 体面的； 宽厚的， 大方的； 正派的； 合乎礼仪的， 得体的
award	n. 奖，奖品；判定 vt. 授予， 给予； 判给， 裁定
famine	n. 饥荒； 严重的缺乏
cripple	n. 跛子，伤残人 vt. 使跛， 使受伤致残； 严重削弱， 使陷入瘫痪
spontaneous	adj. 自发的， 无意识的； 自然的， 天真率直的
contract	v. 缩小； 订合同； 感染， 染上 n. 契约， 合同
rigorous	adj. 严格的
subtle	adj. 微妙的， 难以捉摸的； 诡秘的， 狡诈的； 隐约的
stubborn	adj. 顽固的， 执拗的， 倔强的； 难对付的， 难于克服的
fatal	adj. 致命的， 灾难性的， 毁灭性的； 重大的， 决定性的
solo	adv. 以独力，单独地 adj. 单独的，单独进行的 n. 独奏， 独唱， 独舞
missionary	n. 传教士
community	n. 社区， 社会， 公社； 团体， 界； 群落
optical	adj. 眼的， 视觉的； 光学的
economy	n. 经济； 节约， 节省
magistrate	n. 地方行政官， 地方法官； 治安官
revive	v. 复苏
resemblance	n. 相似， 形似
spouse	n. 配偶
proficiency	n. 熟练， 精通
various	adj. 各种各样的， 不同的
argue	vi. 争论，争辩，辩论 vt. 主张； 说服
geology	n. 地质学； 地质情况
merit	n. 长处，优点；价值；功劳，成绩 vt. 值得， 应受
fabric	n. 织物， 纺织品； 结构
bowel	n. 肠； 内部， 深处
federation	n. 联合会； 联邦
interfere	vi. 干涉， 干预， 妨碍
subtract	vt. 减， 减去； 去掉
extraordinary	adj. 非同寻常的， 特别的
exclusive	adj. 奢华的，高级的；独有的；排斥的；不包括…的 n. 独家新闻
substantial	adj. 可观的， 大量的； 物质的， 坚固的； 实质的， 真实的
handicap	n. 缺陷；障碍，不利条件 vt. 妨碍， 使不利
repay	vt. 归还； 报答
emergency	n. 紧急情况， 突然事件
evolution	n. 进化， 演化； 发展
machinery	n. 机器， 机械
endeavor	v. 努力，尽力 n. 努力，尝试
belly	n. 肚子， 腹部
allowance	n. 津贴，补助费
formidable	adj. 可怕的， 令人敬畏的； 难以克服的， 难对付的
surplus	adj. 过剩的， 多余的 n. 过剩，剩余，盈余
assimilation	n. 同化， 同化作用； 消化
original	adj. 最初的；新颖的；原版的 n. 原件， 原作
peculiar	adj. 奇怪的， 古怪的； 特有的
respective	adj. 各自的， 各个的， 分别的
withhold	vt. 拒绝， 不给； 抑制， 制止
crack	v. 发出爆裂声
execute	vt. 将…处死； 实施
ventilate	vt. 使通风； 把…公开， 公开讨论
blunder	vi. 跌跌撞撞地走， 慌乱地走； 犯错误 n. 错误
premature	adj. 比预期时间早的； 不成熟的， 仓促的
hurl	vt. 猛投， 狠掷； 大声叫骂
colleague	n. 同事， 同僚
authentic	adj. 真的， 真正的； 可靠的， 可信的
justify	vt. 证明…是正当的
slot	n. 狭缝，狭槽；位置，空位 vt. 把…放入狭长开口中； 把…纳入其中， 使有位置
pattern	n. 型，式样；模，模型 vt. 仿制， 使…仿效
curb	vt. 控制，约束 n. 控制， 约束； 路缘
account	vi. 说明…的原因； 占… n. 记述；解释；账目
extreme	adj. 极度的；最后的 n. 极端， 过分
savage	adj. 残暴的，凶猛的，粗鲁的；未开化的，野蛮的 n. 野蛮人，粗鲁的人 vt. 乱咬； 激烈抨击
sanction	vt. 批准，认可 n. 批准， 认可； 约束因素， 约束力； 国际制裁
medication	n. 药物治疗； 药物
oak	n. 栎树， 橡树； 栎木， 橡木
linear	adj. 线的， 直线的， 线状的； 长度的； 线性的
previous	adj. 先的， 前的， 以前的
stab	n&v. 刺， 戳
pendulum	n. （钟等的）摆
loyalty	n. 忠诚， 忠心
attract	vt. 吸引， 引起…注意
vulgar	adj. 粗野的， 下流的； 庸俗的， 粗俗的
vacant	adj. 空的， 未被占用的； 空缺的； 茫然的， 空虚的
cancel	vt. 取消， 撤销， 删去
instinct	n. 本能； 直觉， 生性
periodic	adj. 周期的， 定期的， 时而发生的
ornament	n. 装饰品，点缀品；装饰，点缀 vt. 装饰， 点缀， 美化
indignant	adj. 愤怒的， 愤慨的， 义愤的
ballet	n. 芭蕾舞， 芭蕾舞剧； 芭蕾舞团
thrill	v. 非常兴奋， 非常激动 n. 兴奋，激动；引起激动的事物
strive	vi. 努力， 奋斗， 力求
staple	adj. 主要的； 经常需要的 n. 订书钉，U形钉；主食；主要产品 vt. 用订书钉订
femininity	n. 女性气质
offset	vt. 补偿， 抵消
reward	n. 报答，奖赏；报酬，酬金 vt. 报答， 酬谢， 奖励
workshop	n. 车间， 工场； 专题讨论会
imitation	n. 模仿； 仿制， 伪制品； 赝品
inhibit	vt. 阻止， 妨碍， 抑制
suite	n. 套间； 一套家具； 套， 组， 系列
factor	n. 因素， 因子； 系数
lease	n. 租约，租契 vt. 出租； 租得， 租有
howl	n&vi. 嗥叫； 呼啸； 吼叫， 哀号
overhead	adv. 在头顶上 adj. 在头顶上的；架空的 n. 经常费用， 管理费用
rectangular	adj. 长方形的， 矩形的
scar	v. 留下伤痕 n. 伤疤，伤痕；创伤
confidence	n. 信任， 信赖； 信心， 自信
consecutive	adj. 连续的， 连贯的
receipt	n. 发票， 收据； 收入， 进款； 收到， 接到
ranch	n. （北美洲的）大牧场
rap	vi. 说唱 vt. 敲击，急敲；突然厉声说出；责备，训斥 n. 敲击， 急敲
racial	adj. 种族的， 人种的
stationary	adj. 固定的， 静止不动的
detail	n. 细节，枝节；零件 vt. 详细说明
fragrance	n. 芳香， 香味； 香水
brochure	n. 小册子
annual	adj. 每年的，一年一次的 n. 年报， 年鉴； 一年生的植物
identification	n. 身份证明； 鉴定， 验明， 认出； 认同
consequently	adv. 因此， 因而， 所以
wrinkle	v. 起皱纹 n. 皱纹
accelerate	vt. 使加快， 使增速
sympathetic	adj. 同情的； 和谐的； 赞同的， 支持的； 合意的
devise	vt. 设计， 发明
subculture	n. 亚文化
counter	n. 柜台； 计数器； 筹码
intuition	n. 直觉； 由直觉获知的信息
corps	n. 队， 部队； 一组
scoop	v. 舀出； 抢在之前报道新闻 n. 勺子；抢先报道的新闻
manufacture	vt. 制造，加工 n. 制造， 制造业
contend	vi. 争夺，竞争；搏斗，争斗 vt. 声称， 主张
grief	n. 悲哀，悲痛，悲伤
tedious	adj. 冗长乏味的， 沉闷的
clone	v. 无性繁殖， 克隆 n. 无性繁殖系，克隆；复制品，翻版
enforce	vt. 实施， 执行； 强制， 强迫， 迫使
intimate	adj. 亲密的，个人的 n. 至交， 密友 vt. 暗示， 提示
plague	n. 瘟疫，鼠疫；灾难，祸患 vt. 使痛苦， 给…造成困难
broaden	v. 放宽，变阔
wallet	n. 皮夹子
intercourse	n. 性交； 交流， 交往， 交际
stability	n. 稳定， 稳固
compact	adj. 紧凑的，小巧的；坚实的 vt. 把…压实，使坚实['kɔmpækt] n. 契约， 合同
perpetual	adj. 永久的， 永恒的， 长期的； 无休止的， 没完没了的
dodge	vi. 闪身躲开 vt. 回避，逃避 n. 托辞， 伎俩； 躲闪， 躲避
eloquent	adj. 雄辩的， 口才流利的， 有说服力的； 明白显示出的
limp	vi. 一瘸一拐地走，蹒跚 adj. 软弱的，无生气的，无精神的；软的，松沓的 n. 跛行
mobile	adj. 运动的；流动的；多变的 n. 移动电话
spectator	n. 观众， 旁观者
ancient	adj. 古代的， 古老的； 年老的， 看上去很老的
aid	n. 帮助，救护；助手，辅助手段 vt. 帮助， 援助
bull	n. 公牛； 雄兽； 买进证券投机图利者， 看涨的人
shepherd	n. 牧羊人，羊倌 vt. 带领， 引导
accordance	n. 一致， 和谐， 符合
explicit	adj. 详述的， 明确的， 明晰的； 直言的， 露骨的
barely	adv. 仅仅， 只不过， 几乎不
margin	n. 页边空白； 差数， 差额； 余地； 边缘
complexion	n. 肤色， 面色； 局面； 性质
analogous	adj. 类似的， 相似的； 可比拟的
item	n. 条， 条款
pressure	n. 压，压强；压迫 vt. 对…施加压力， 迫使， 说服
target	n. 靶， 标的， 目标
dart	vi. 猛冲，飞奔 vt. 投射 n. 飞镖， 飞镖游戏； 急驰， 飞奔
speculate	v. 推测， 推断； 投机， 做投机买卖
verge	vi. 接近， 濒临 n. 边，边缘
eclipse	n. 食；消失，黯然失色 vt. 食， 遮掩光； 使暗淡， 使失色， 使相形见绌
pessimistic	adj. 悲观的
longevity	n. 长寿， 寿命
discriminate	vi. 区别， 辨别； 有差别地对待， 歧视
cannon	n. 加农炮， 大炮， 火炮
predecessor	n. 前任， 前辈； 原有事物， 前身
expression	n. 词语； 表达， 表情
excursion	n. 远足， 短途旅行
atmosphere	n. 大气， 空气； 气氛， 环境
alienate	vt. 使疏远， 使不友好， 离间； 转让， 让渡
recreation	n. 娱乐活动， 消遣
adopt	vt. 收养； 采用， 采取； 正式通过， 批准
expedition	n. 旅行， 远征； 远征队， 探险队， 考察队； 迅速， 动作敏捷
fabricate	vt. 捏造， 伪造， 编造； 建造
assignment	n. 任务； 指定的作业； 分配， 指派
abuse	vt. 滥用； 虐待； 辱骂， 毁谤 n. 滥用； 虐待； 辱骂
constitute	vt. 组成， 形成； 设立； 任命
rein	n. 缰绳 vt. 勒缰使停步； 控制， 约束
muscular	adj. 肌肉发达的， 强壮的； 肌肉的
formal	adj. 正式的； 礼仪上的
foremost	adj. 最好的， 最著名的， 最重要的
violate	vt. 违反， 违背； 亵渎； 侵犯， 妨碍
accompany	v. 陪同， 伴随； 为…伴奏
scramble	v. 爬行，攀登 n. 爬行，攀登
trench	n. 沟， 沟渠
doubtless	adv. 无疑地， 肯定地
aggregate	adj. 总计的， 合计的 n. 总数，合计 vt. 总计达， 合计； 使聚集， 使积聚
infer	v. 推断
conscious	adj. 意识到的， 自觉的； 神志清醒的； 有意的， 存心的
decay	vi. 腐烂，衰败 n. 腐烂， 衰败状态
descend	vi. 下来，下降 vt. 走下， 爬下
alcohol	n. 酒精， 乙醇
equivalent	adj. 相等的，等量的 n. 相等物， 等价物
telecommunications	n. 通信， 电信
beverage	n. 饮料
classic	adj. 最优秀的，典型的，标准的；传统式样的，典雅的 n. 文学名著，经典作品，杰作；优秀的典范；
overwhelm	vt. 使受不了， 使不知所措； 征服， 制服
overwhelming	adj. 势不可挡的， 压倒的； 巨大的
climax	n. 高潮， 最令人兴奋的部分
costume	n. 服装， 服饰； 戏装， 成套服装
transcend	vt. 超出， 超越范围
stern	adj. 严厉的，严格的，严峻的 n. 船尾
curse	v. 诅咒，咒骂，天谴 n. 祸害， 祸根； 咒骂， 诅咒， 咒语
vocational	adj. 职业的， 业务的
indulge	vi. 沉溺， 纵容自己， 肆意从事 vt. 使沉溺于，满足；纵容，迁就
buzz	v. （蜂等）嗡嗡叫
popularity	n. 普及， 流行； 声望
contradiction	n. 矛盾， 不一致； 否认， 反驳
provoke	vt. 对…挑衅， 激怒； 激起， 引起
slum	n. 贫民窟
display	n&vt. 陈列， 展览； 显示
ideology	n. 思想， 思想意识
modest	adj. 谦虚的； 适中的； 羞怯的
insist	v. 坚持； 坚持要求； 坚决认为
avail	v. 有帮助； 有益； 有用 n. 效用，利益，帮助
arrangement	n. 整理， 排列； 安排； 准备工作
ideal	adj. 理想的，观念的，空想的 n. 理想， 理想的东西
interrupt	v. 打断， 中止； 打扰
verse	n. 诗， 诗句
dwarf	adj. 矮小的，发育不全的 n. 矮子，侏儒 vt. 使显得矮小， 使相形见绌
revolve	vi. 旋转
compound	adj. 复合的，化合的 n. 化合物，复合物；复合词 vt. 使恶化， 加重； 使化合， 使合成
standpoint	n. 立场， 观点
grab	v. 攫取，抓取
amend	vt. 修改，修订，改进 n. 赔罪， 赔偿
spy	vi. 当间谍；暗中监视 n. 间谍 vt. 看见， 发现
hoist	vt. 举起，升起，吊起 n. 起重器械； 举起， 升起， 吊起
primitive	adj. 原始的，早期的；简单的；粗糙的 n. 原人； 原始事物
conflict	vi. 冲突， 抵触 n. 冲突， 抵触； 争论； 战斗， 战争
wrench	vt. 猛拧，猛扭；挣脱；使扭伤 n. 痛苦， 难受； 猛扭， 猛拉； 扳手
furthermore	adv. 而且， 此外
squat	v. （使）蹲下
captive	adj. 被俘虏的，被捕获的 n. 俘虏
exaggerate	v. 夸大， 夸张
rivalry	n. 竞争， 竞赛； 对抗
Easter	n. 复活节
preside	vi. 主持，主管
terminate	v. 停止，终止
glance	vi. 看一下 n. 一瞥
apology	n. 道歉， 认错， 谢罪
delusion	n. 欺骗； 哄骗
concede	vi. 让步， 认输 vt. 承认，承认…为真；承认失败；允许，让予
hospitality	n. 友好款待， 好客
yield	v. 出产；让出，放弃；屈服，顺从；倒塌，垮掉 n. 产量
additional	adj. 附加的， 追加的
beam	v. 面露喜色； 定向发出， 播送 n. 梁，横梁；束，柱；笑容，喜色
ceramic	adj. 陶器的 n. 陶瓷器
complication	n. 困难， 难题； 并发症
stream	v. 流出， 涌出 n. 河，溪流；一股，一串
passion	n. 激情， 热情； 酷爱
switch	n. （树木的）软枝条
slaughter	n&vt. 屠杀， 杀戮； 屠宰
affection	n. 感情； 爱， 爱慕
preview	n. 预映， 预演； 预告
flank	n. 肋，肋腹，侧边；侧翼 vt. 位于…的侧面
testimony	n. 证词； 见证， 证明
bulk	v. 变得越来越大； 使更大 n. 物体，体积；大批
fret	v. （使）烦恼
interim	adj. 暂时的，临时的 n. 间歇， 过渡期间
agreeable	adj. 令人愉快的， 惬意的； 同意的， 乐意的
inhabitant	n. 居民， 住户
enormous	adj. 巨大的， 庞大的
decrease	v. 减少 n. [dI'kriːs]
aisle	n. 过道， 通道
endure	v. 忍受， 容忍； 持久， 持续
current	adj. 当前的，通用的；流行的，流传的 n. 潮流； 电流； 趋势， 倾向
cope	vi. 应付， 处理
rejection	n. 拒绝
benefit	vi. 得益 n. 利益，恩惠；救济金，保险金，津贴 vt. 有益于
recession	n. 衰退， 衰退期
graze	vi. 吃青草 vt. 放牧；擦伤；擦过，掠过 n. 擦破
bang	v. 猛击， 猛撞； 发出砰的一声， 砰砰地响； 砰地敲 n. 巨响；枪声；猛击
grin	n. 咧嘴笑
tread	v. 踩，踏，践踏
recur	vi. 再发生， 重现
attitude	n. 态度， 看法； 姿势
virtual	adj. 实质上的， 事实上的， 实际上的
compose	vt. 组成， 构成； 创作， 为…谱曲； 使平静， 使镇静
outline	n. 提纲，要点；外形；略图 vt. 概述； 描…的外形
extinct	adj. 灭绝的， 绝种的； 不再活跃的， 熄灭了的， 已废弃的
derive	vi. 起源， 衍生 vt. 取得，得到；追溯…的起源或来由
impart	vt. 告知， 透露； 赋予， 给予
consult	vt. 请教； 查阅； 商议
define	vt. 给…下定义， 限定
tan	vi. 晒成棕褐色 vt. 使晒成棕褐色；硝制 n. 棕褐色， 棕黄色； 晒成棕褐色， 晒黑
commemorate	vt. 纪念， 庆祝
pregnancy	n. 怀孕
module	n. 组件， 模块， 模件； 舱
specific	adj. 特有的；明确的；具体的 n. 详情， 细节
counter	adv. 相反地 adj. 相反的
lure	vt. 吸引，引诱，诱惑 n. 吸引力， 诱惑物； 诱饵， 鱼饵
confer	vi. 商谈，商议 vt. 授予， 赋予
underlying	adj. 在下面的； 含蓄的； 潜在的
endurance	n. 忍耐力； 持久， 耐久
panic	v. 恐慌， 惊慌失措 n. 恐慌，惊慌，慌乱
outset	n. 开始， 开端
integrity	n. 正直， 诚实， 诚恳； 完整， 完全， 完善
proximity	n. 接近， 邻近
orbit	n. 轨道 vt. 作轨道运行
suspension	n. 暂停， 中止； 暂令停止参加， 暂时剥夺； 悬架， 悬置机构； 悬浮液； 悬， 挂， 吊
responsible	adj. 需负责任的， 承担责任的； 有责任感的， 负责可靠的； 责任重大的， 重要的
situation	n. （建筑物等的）位置
prospect	n. 前景， 前途， 可能性； 景象， 景色； 可能成为主顾的人， 有希望的候选人
conduct	n. 举止，行为；指导；管理，实施	[kən'dʌkt] vt. 进行； 管理， 指挥， 引导； 传输， 传导
facet	n. 一个方面； 面
comparison	n. 比较， 对照； 比拟， 比喻
yacht	n. 快艇， 帆船， 游艇
bargain	vi. 讨价还价 n. 特价商品；协议，交易
typical	adj. 典型的， 有代表性的
disaster	n. 灾难， 灾祸， 天灾； 彻底的失败
ridicule	v. 嘲弄，挖苦 n. 嘲弄，挖苦
tempt	vt. 吸引， 引起…的兴趣； 引诱， 诱惑
caution	n. 小心，谨慎；注意，警告 vt. 警告， 劝…小心
extent	n. 广度； 范围； 程度
embark	vi. 上船； 着手， 开始工作
outbreak	n. 爆发， 突然发生
audience	n. 听众， 观众； 读者
flutter	vi. 振翼，拍翅而飞；飘动，飘扬；快速跳动 n. 紧张， 激动不安
commentary	n. 实况报道， 解说词； 评论， 评论文章
plead	vi. 恳求，请求；申诉，答辩，辩护 vt. 为…辩护， 提出…为理由
adjoin	vt. 贴近； 与…毗连
encounter	vt. 遭遇，遇到 n. 遭遇
discard	vt. 丢弃， 抛弃， 遗弃
consequent	adj. 作为结果的， 随之发生的
patron	n. 资助人， 赞助人； 老主顾， 顾客
abstract	adj. 抽象的，抽象派的 n. 摘要，梗概；抽象派艺术作品
sacrifice	n&v. 牺牲， 舍身； 献祭， 供奉； 祭品
modify	vt. 更改， 修改； 修饰
notwithstanding	adv. 尽管
stereo	adj. 立体的；立体声的 n. 立体声
aggressive	adj. 侵略的， 好斗的； 敢作敢为的； 有进取心的
slip	v. 滑跤，滑落，溜；下降，跌落；悄悄放进 n. 疏漏， 差错
wedge	n. 楔 vt. 楔入， 塞入
segregate	vt. 使隔离， 使分开
pursue	vt. 继续， 从事； 追赶， 追踪； 追求
tribute	n. 颂词， 称赞， 礼物； 贡品
vacuum	v. 收集； 用真空吸尘器打扫 n. 真空；真空吸尘器
frantic	adj. 慌乱不安的； 发疯似的， 发狂的
ethnic	adj. 种族的
depress	vt. 使沮丧， 使不景气； 按下
whereby	adv. 凭此； 借以； 由于
heighten	v. 提高， 加强
scramble	vi. 攀登，爬；争夺，抢夺 vt. 扰乱，搞乱 n. 攀登， 爬行； 争夺， 抢夺
prevalent	adj. 流行的， 普遍的
exaggeration	n. 夸张； 夸大之词
process	n. 过程；制作方法；程序 vt. 加工， 办理
detain	vt. 拘留， 扣留； 留住， 耽搁
dismiss	vt. 不再考虑； 解雇， 解散； 驳回
compel	vt. 强迫， 迫使屈服
terminate	v. 停止， 终止
slide	v. 滑；悄悄地移动 n. 滑动； 滑道， 滑面； 幻灯片
indispensable	adj. 必不可少的， 必需的
dismantle	vt. 拆开， 拆卸
competence	n. 能力， 胜任， 称职
shrug	v. 耸（肩） n. 耸肩
weary	vi. 厌烦， 不耐烦 adj. 疲劳的，疲倦的；使人疲劳的，令人厌倦的
customary	adj. 习惯上的， 惯常的， 合乎习俗的
axle	n. （轮）轴，车轴，心棒
notify	vt. 通知， 告知； 报告
asset	n. 资产， 财产； 有价值的特性或技能， 优点
legend	n. 传说， 传奇故事； 传奇人物
deficiency	n. 缺乏， 不足； 缺点， 缺陷
outfit	n. 全套服装； 一组人； 全套装备， 全套工具
electrician	n. 电工， 电气技师
drought	n. 干旱， 旱灾
vigorous	adj. 朝气蓬勃的； 有力的， 用力的
refusal	n. 拒绝
staircase	n. 楼梯
spine	n. 脊柱， 脊椎； 刺， 刺毛； 书脊
willful	adj. 故意的， 特意的
heir	n. 继承人
indignation	n. 愤怒， 愤慨， 义愤
idiom	n. 习语， 成语； 风格， 特色
manufacturer	n. 制造商， 制造厂
mature	adj. 成熟的，成年人的；深思熟虑的；到期的，应支付的 vt. 使成熟
priest	n. 神父， 牧师
misfortune	n. 不幸， 厄运， 逆境； 不幸事故， 灾难， 灾祸
hemisphere	n. 地球的半球； 大脑半球
indicative	adj. 标示的，指示的，象征的；陈述的 n. 【语】陈述语气
lame	adj. 跛的， 瘸的； 站不住脚的， 差劲的； 蹩脚的
pearl	n. 珍珠； 珠状物； 珍品
encourage	vt. 鼓励， 怂恿； 促进， 助长， 激发
hamper	vt. 妨碍，束缚，限制 n. 大篮子
financial	adj. 财政的， 金融的
intensive	adj. 加强的； 精耕细作的
recognize	vt. 认出， 识别； 承认， 确认， 认可； 赏识， 表彰， 报偿
flare	vi. 闪耀，烧旺；突发，突然发怒 n. 闪光信号， 照明弹
stable	adj. 稳定的，不变的；沉稳的，持重的 n. 厩， 马厩， 牛棚
approve	vi. 赞成， 称许 vt. 赞成，称许；批准
transaction	n. 交易， 业务
arouse	vt. 引起； 唤起， 唤醒
obedient	adj. 服从的， 顺从的
inherent	adj. 内在的； 固有的， 生来就有的
detection	n. 察觉， 发觉； 侦查， 探测
constant	adj. 经常的，不断的，连续发生的；永恒的；忠实的，忠诚的 n. 常数， 恒量
culminate	vi. 告终
quota	n. 定额， 限额， 配额
casualty	n. 伤亡人员， 死伤者； 受害人， 损失的东西
attendant	adj. 伴随的， 随之产生的 n. 服务人员，侍者，随从
authority	n. 官方； 权力； 当权者， 行政管理机构； 权威， 专家
commonwealth	n. [C-]英联邦； 联邦， 联合体
flutter	v. （鸟）振翼；飘动
distort	vi. 变形 vt. 歪曲，曲解；扭曲，使变形
reproach	n&vt. 责备， 批评
barrier	n. 栅栏； 检票口； 屏障； 障碍， 隔阂
investigate	v. 调查， 研究
beware	v. 谨防，当心
fringe	adj. 附加的 n. 刘海；饰以流苏的边；边缘，外围 vt. 成为…的边缘
grope	vi. 暗中摸索，搜索；探索，搜寻 vt. 摸索
unanimous	adj. （全体）一致的
dispatch	vt. 派遣，调遣，发送 n. 急件， 快信； 新闻报道； 派遣， 调遣
occupation	n. 占领， 占据； 职业； 从事的活动， 消遣
involve	vt. 使卷入， 牵涉； 包含， 含有
console	vt. 安慰，慰问 n. 控制台， 操纵台
segment	n. 部分， 片段； 瓣
incidentally	adv. 顺便提及地， 顺便提一句
luminous	adj. 发光的， 发亮的； 光明的
numerous	adj. 众多的
compete	vi. 比赛， 竞争， 对抗
descendant	n. 后裔， 后代
tighten	v. （使）变紧
insert	vt. 插入， 嵌入； 登载
navigation	n. 航行， 航海， 航空； 导航， 领航
polish	vt. 磨光；修改，润色，使优美 n. 擦光剂
execution	n. 死刑； 实行， 执行， 履行； 演奏， 表演
pumpkin	n. 南瓜
underestimate	vt. 对…估计不足，低估 n. 估计不足， 低估
crucial	adj. 至关重要的， 决定性的
considerate	adj. 考虑周到的， 体贴的， 体谅的
critic	n. 批评家， 爱挑剔的人
formulate	vt. 构想出， 规划； 系统地阐述
contemplate	vt. 盘算， 计议； 思量， 对…周密考虑； 注视， 凝视
brief	adj. 简短的，短暂的 vt. 向…介绍基本情况，做…的提要 n. 概要， 摘要
litter	vi. 乱扔废弃物 vt. 乱扔东西 n. 废弃物， 被胡乱扔掉的东西； 一窝； 杂乱的东西
deduct	v. 减去， 扣除
fitting	adj. 适合的， 恰当的 n. 设备，家具，日用器具；配件，附件，零件；试穿，试衣
author	n. 著作家， 作者
consume	vi. 消灭， 毁灭 vt. 消费；吃完，喝光
logical	adj. 逻辑的， 合乎常理的
expansion	n. 扩大； 扩充； 扩张； 膨胀
fold	vt. 折叠，合拢 n. 褶， 折叠的部分
clash	vi. 发生冲突；不协调；砰地相撞，发出刺耳的撞击声 n. 冲突； 不协调； 刺耳的撞击声
apartment	n. 一套公寓房间
pier	n. 码头；（桥）墩
complicated	adj. 复杂的， 难懂的
promote	vt. 促进， 增进， 发扬； 提升； 宣传， 推销
mansion	n. 大厦， 宅邸
mall	n. 购物中心
energetic	adj. 精力充沛的， 充满活力的
command	n&vt. 命令， 指挥； 控制
timid	adj. 羞怯的， 胆小的
dilemma	n. 窘境， 困境
flip	adj. 〈口〉无理的， 轻率的， 轻浮的 vt. 快速翻动，转动 n. 捻掷，轻抛；轻拍
dictate	v. ['dIkteIt] n. 口授； 命令， 规定， 要求
superiority	n. 优越， 优等
reunion	n. 重聚， 团聚； 聚会， 联谊活动
virtually	adv. 事实上， 实质上
definition	n. 定义， 释义， 定界； 清晰， 鲜明
crime	n. 罪， 罪行， 犯罪
ingenious	adj. 设计独特的， 别致的， 巧妙的； 灵巧的， 善于创造发明的
elaborate	adj. 复杂的； 精心制作的 v. 详述， 详细制定
paralysis	n. 麻痹， 瘫痪， 中风； 无能， 无力
diffuse	v. 扩散， 弥漫； 传播， 散布 adj. 冗长的， 漫无边际的； 四散的， 弥漫的
allowance	n. 津贴， 补贴； 零用钱
blaze	vi. 熊熊燃烧，着火；发光，放光彩；迸发，爆发 n. 火焰， 烈火； 光辉， 强烈的光； 迸发， 爆发； 灿烂， 炫耀
merge	v. 结合， 合并， 合为一体
peel	vi. 剥落，脱皮 vt. 削…的皮，剥…的壳 n. 皮， 外衣
resent	vt. 对…表示愤恨， 怨恨
motive	n. 动机， 目的
rehearsal	n. 排练， 排演
sequence	n. 连续， 接续， 一连串； 次序， 顺序
clarity	n. 清楚， 明晰
wrestle	n. 摔跤； 斗争， 搏斗
basis	n. 基础， 根据； 原则
wealthy	adj. 富的， 富裕的
pace	v. 踱步
commercial	adj. 商业的， 商务的； 商品化的， 商业性的
renaissance	n. 文艺复兴， 文艺复兴时期； 复兴， 再生
vice	n. 罪恶， 恶习， 缺点； 虎钳
skeleton	n. 骨骼； 框架， 骨干； 梗概， 提要
fuel	n. 燃料，燃料剂 vt. 给…加燃料； 刺激
ancestor	n. 祖宗， 祖先； 原型； 先驱
overcome	vt. 战胜， 克服； 压倒， 使受不了
patriotic	adj. 爱国的， 有爱国心的， 显示爱国精神的
elastic	adj. 有弹性的； 灵活的 n. 松紧带
marshal	n. 元帅，最高指挥官；总指挥，司仪；执法官，警察局长，消防队长 vt. 整理， 排列， 集结
connection	n. 连接； 联系； 连接物， 连接点； 亲戚
accommodation	n. 住处， 膳宿
terrace	n. 排屋；地坪，草坪；
expense	n. 花费， 消费， 费用； 开支， 业务费用
cycle	n&v. 自行车、 摩托车； 循环
adjust	vi. 适应 vt. 调整，调节；校正
immigrate	v. （使）移居入境
repression	n. 压抑， 压制， 镇压
literacy	n. 识字， 有文化， 读写能力
massacre	vt. 大规模屠杀，残杀；彻底击败 n. 大屠杀， 残杀； 惨败
disastrous	adj. 灾难性的， 造成灾害的； 极坏的， 很糟的
escort	v. 护卫，护送 n. 护卫者，护送车辆
recruit	vt. 招募， 吸收
citizenship	n. 公民的身份, 公民的职责和权力
release	n&vt. 释放， 排放； 解除， 解脱； 放开， 松开； 发布； 发行
boost	v. 推动， 促进， 激励； 替…做广告， 宣扬； 提高， 使增长 n. 提高，增长；推动，激励
qualitative	adj. 性质的， 定性的
issue	v. 发行； 分发， 发出 n. 问题；发行；分发
gleam	n&vi. 闪亮， 闪烁； 闪现， 流露
squad	n. 班， 小队， 小组
cylinder	n. 圆柱体， 圆筒； 气缸， 泵体
flap	v. 拍打 n. 拍打，拍动
relish	vt. 享受，从…中获得乐趣 n. 享受， 滋味， 乐趣； 调味品
esthetic	adj. 美学的， 审美的； 悦目的， 雅致的
quantitative	adj. 量的， 定量的
substance	n. 物质； 实质； 大意， 要旨； 根据， 理由
realistic	adj. 现实的； 实际可行的； 现实主义的， 逼真的
opponent	n. 对手； 敌手， 对抗者
credible	adj. 可信的， 可靠的
obtain	vi. 通用， 流行； 存在 vt. 获得
reference	n. 提到， 论及； 参考， 查阅； 引文； 参考书目； 证明书， 推荐信
riot	n. 骚乱，暴乱 v. 发动骚乱
aesthetic	adj. 美学的， 审美的； 悦目的， 雅致的
magnet	n. 磁铁， 磁体； 有吸引力的人和事物
jerk	v. 猝然一动，猛拉 n. 急推， 急拉， 急扭
tow	v. 拖引，牵引 n. 拖引，牵引
trample	v. 践踏，蹂躏 n. 践踏，蹂躏
drainage	n. 排水系统， 下水道； 排水， 放水
implication	n. 含意， 暗示， 暗指； 卷入， 牵连
corrupt	adj. 堕落的，腐败的，贪赃舞弊的 vt. 腐蚀， 使堕落
convenience	n. 方便； 便利设施
appendix	n. 阑尾； 附录
disposable	adj. 可任意使用的 n. 一次性物品， 不回收物品
tanker	n. 油轮
closet	adj. 私下的；隐蔽的 n. 橱，壁橱 vt. 把…引进密室会谈
drain	v. （水等）流掉
mortal	adj. 终有一死的；致命的；你死我活的，不共戴天的 n. 凡人， 人类
wealth	n. 财富； 财产； 丰富
alliance	n. 结盟； 联盟
statesman	n. 国务活动家， 政治家
solitary	adj. 单独的， 独自的； 单个的， 唯一的； 孤独的， 隐居的
sustain	vt. 保持， 使持续下去； 供养， 维持； 支持， 支撑； 经受， 遭受
impulsive	adj. 冲动的
recite	v. 背诵， 朗诵； 列举， 一一说出
shade	n. （色彩的）浓淡，深浅
streamline	vt. 使成流线型； 精简， 使效率更高
jog	n&v. 慢跑； 轻轻碰撞
distract	vt. 转移， 使分心
package	n. 包裹，包装；一揽子交易 vt. 把…打包； 包装
subsidiary	adj. 辅助的，次要的，附设的 n. 子公司， 附属机构
notation	n. 记号， 标记法
mob	n. 暴民，乌合之众 vt. 成群围住， 聚众袭击
trivial	adj. 琐碎的， 不重要的
confusion	n. 困惑， 糊涂； 混淆； 骚乱
border	vi. 近似， 与…接壤 n. 边，边缘，边界 vt. 给…加上边，围；邻接
spill	n. （人）摔下，跌下
prune	vt. 修剪， 修整； 删除， 削减
glow	vi. 发光； 燃烧 n. 白热光；脸红；激情
cast	vt. 投，扔，抛；浇铸 n. 演员表， 全体演员； 石膏绷带； 铸型， 铸件； 投， 抛
expose	vt. 使暴露， 揭露
swell	v. 使膨胀；隆起
assimilate	vi. 被吸收， 被消化； 被同化 vt. 吸收，消化；使同化
sensitive	adj. 敏感的， 灵敏的； 神经过敏的， 容易生气的； 易受伤害的
veteran	adj. 经验丰富的 n. 老手；老兵
ultimate	adj. 最后的，最终的 n. 终极， 顶点
intelligible	adj. 可理解的， 明白易懂的， 清楚的
sample	n. 样品，试样，样本 vt. 从…抽样； 品尝， 体验
reaffirm	vt. 重申； 再确认
recall	vt. 回忆； 召回， 叫回； 收回， 撤销
deadly	adv. 非常， 极度地 adj. 致死的，致命的；不共戴天的；极度的，十足的
disable	vt. 丧失能力， 伤残
represent	vt. 作为…的代表， 表示， 象征； 描绘， 表现
defiance	n. 违抗； 藐视
commence	v. 开始
temper	n. 韧度；心情，情绪 vt. 调和， 使缓和； 回火
intrinsic	adj. 固有的； 本质的； 内在的
combination	n. 结合， 联合； 化合
kit	n. 成套工具，成套用品；配套元件 vt. 装备
breach	n. 破坏，违反；破裂，不和；缺口，裂口 vt. 攻破， 在…造成缺口； 破坏， 违反
defeat	n&vt. 战胜， 挫败
petty	adj. 小的， 琐碎的； 不重要的； 气量小的， 心胸狭窄的
nourish	vt. 养育， 喂养， 滋养； 怀有， 增强
pore	vi. 仔细阅读， 审视 n. 毛孔，细孔
reinforce	vt. 增强， 加强， 增援
prestige	n. 威信， 威望
fraction	n. 小部分， 片断； 【数】 分数
synthesis	n. 综合； 合成
multitude	n. 大量， 许多； 大众， 民众
consequence	n. 结果， 后果； 重要， 重大
stump	vi. 脚步沉重地走 n. 树桩；残根，残余部分 vt. 把…难住，使为难；在…做巡回演说
element	n. 成分， 要素， 元素； 基础， 纲要； 自然力
messenger	n. 送信人， 信使
predestine	vt. 预先确定； 注定
revelation	n. 被提示的真相， 新发现； 揭示， 透露， 显示
prescient	adj. 预知的， 预见的
universe	n. 宇宙， 世界； 领域， 范围
penalty	n. 处罚， 惩罚； 罚金
lieutenant	n. 陆军中尉； 海军上尉
tackle	vt. 对付，处理；与…交涉；阻截，擒抱 n. 阻截， 擒抱； 用具， 钓具； 辘轳， 滑车
locality	n. 地区， 地点
mutual	adj. 相互的； 共同的
metabolic	adj. 代谢作用的， 新陈代谢的
orientation	n. 方向， 目标， 方位； 熟悉情况， 适应， 情况介绍
internal	adj. 内的， 国内的； 内心的
convene	vi. 开会，集合 vt. 召集
sacred	adj. 神圣的； 宗教的； 神圣不可侵犯的
assertive	adj. 断定的； 过分自信的
diligent	adj. 勤勉的， 勤奋的
